Indecisive - Нерешительна
Leather - Кожа
Fancy - Изысканный
Engaged - Помолвлен
Employer - Работодатель
Headline - Заголовок
Retiring - Пенсия
Embassy - Посольство
Oven - Піч
Wool - Вовна
Sweatshirt - Спортивный свитер
Thrown - Брошенный, забытый
Wedding day - Свадьба день
Waves - Волны
Won't she go to court for stealing - Не пойдет ли она в суд за кражу
Necklace - Ожерелье
Owl - Сова
Underwear - Белье
Stream - Ручей, поток, транслировать
Insect - Насекомое
Trumpet - Труба (муз инструмент)
Quiz - Викторина
Blind - Слепой
Strict - Строгий
Fog - Туман
Parrot - Попугай
Inches - Дюймы
Ugly - Уродливый
Bride - Невеста
Bother - Беспокоить
Does your flight get in at eleven pm - Ваш рейс прибывает в одиннадцать вечера?
Microwave - Микроволновка
Receipt - Квитанция
Tour - Тур
Chip - Обломок
Knee - Колено
Sleeve - Рукав
The rudest - Самый невоспитанный
Cushion - Подушка
Spy - Шпион
Afterward - После
Earrings - Сережки
Cruise - Круиз
Shiny - Блестящий
Shoulder - Плечо
Be fed up with - Достало
Whatever - Всё что угодно
Spare - Запасной
Outdoor - Открытый, с наружи
Creek - Ручей, бухта, залив
Humid - Влажно
Extra - Дополнительный
Fall asleep - Заснуть
Besides - К тому же, Кроме
Cheeks - Щеки
I board the plane - Я сажусь на самолет
Cash register - Касса
A line of seats - Ряд сидений
Hiking - Пеший туризм
Sleeves - Рукава
Groom - Жених
Engagement - Обручение
No way on tv she seems very mean - Ни в коем случае по телевизору она кажется очень злой
Patch - Повязка
Inch - Дюйм
Dirt - Грязь
They dance for a while - Они танцуют некоторое время
Quit - Уволиться
Baggage - Багаж
Did you catch that - Вы поняли это (Ты это уловил?)
Indoor - В помещении, внутри
Seagull - Чайка
Flies - Мухи
Foggy - Туманно
Doll - Кукла
Splash - Всплеск
Knees - Колени
Taking a bath will help you relax - Принятие ванны поможет вам расслабиться
Childhood - Детство
Broom - Метла
It sounds like you're fighting a fever - Похоже, ты борешься с лихорадкой
In exchange for - В обмен на
Come over - Приезжать
Have me over - Пригласи меня
I'm in a hurry - Я спешу
Fee - Платёж
Won't we be late - Мы не опоздаем
Diary - Дневник
Let's remain friends - Давай останемся друзьями
Wet - Мокрый
Chess - Шахматы
Corn - Кукуруза
Frying pan - Сковорода для жарки
Relatives - Родственники
Bugs - Жуки
Annoyed - Раздраженный
Accountant - Бухгалтер
Gift - Подарок
Firmly - Твёрдо
Firefighters - Пожарные
It's produced in Italy - Это производится в Италии
Towel - Полотенце
Straw - Трубочка
Beside - Рядом
Pillow - Подушка
Cute - Милый
Relative - Родственник
Jail - Тюрьма
Niece - Племянница
Neighbour - Сосед
Engage - Привлекать
Scarf - Шарф
Careless - Неосторожный
Mice - Мыши
Bunch - Связка
Spouse - Муж или жена
Talk talked talked - Разговаривать - 3 формы
Unpleasant - Неприятный - Adjective
Involved - Вовлеченный - Adjective
Die - Умерать - Adjective
Hot - Горячий - Adjective
Frightened - испуганный - Adjective
Dirty - Грязный - Adjective
Dangerous - Опасный - Adjective
Blue - Синий - Adjective
Random - Случайный - Adjective
Risky - Рискованно - Adjective
Seamlessly - Плавно - Adjective
Cool - Классный - Adjective
Overwhelmed - Потрясенный - Adjective
Expired - Истекший - Adjective
Responsible - Ответственный - Adjective
Far - Далёкий - Adjective
Busy - Занят - Adjective
Frictionless - Без трения - Adjective
Brave - храбрый - Adjective
Advanced - Продвинутый - Adjective
Stateful - Штатный - Adjective
Inconvenient - Неудобно - Adjective
Generous - Щедрый - Adjective
rid - Избавлятся - Adjective
Dark - Тёмный - Adjective
Above zero - Выше ноля - Adjective
Notably - Примечательно - Adjective
Stupid - Глупый - Adjective
Religious - Верующая, религиозная - Adjective
Drunk - Пьяный - Adjective
Last - Последний - Adjective
Dear - Дорогой, уважаемый - Adjective
general - основной - Adjective
Illegal - Незаконно - Adjective
Loyal - Лояльный - Adjective
Scared - Напуган - Adjective
Close - Близкий, закрыть - Adjective
nervous - испуганный - Adjective
Safe - Безопасно - Adjective
Divorced - Разведен - Adjective
Crazy - Безумный - Adjective
Surprising - Удивительный - Adjective
Needless - Ненужный - Adjective
Rough - Грубый - Adjective
Similarly to - Аналогично - Adjective
Normal - Обычный, нормальный - Adjective
Others - Другие - Adjective
Corresponding - Соответствующий - Adjective
Irritated - Раздражен - Adjective
Foreign - Иностранный - Adjective
Dead - Мёртвый - Adjective
Respectively - Соответственно - Adjective
Big - Большой - Adjective
Less - Менее, меньше - Adjective
Awful - Плохо (пахнет) - Adjective
Unexpectedly - Неожиданно - Adjective
Mortal - Смертельный - Adjective
Economical - Экономный - Adjective
Brown - Коричневый - Adjective
Fast - Быстрый - Adjective
Potential - Потенциальный - Adjective
Current - Текущий (курс) - Adjective
Little - Маленький - Adjective
Loud - Громко - Adjective
Kind - Добрый - Adjective
Prone - Склонный - Adjective
New - Новый - Adjective
Expensive - Дорогой - Adjective
Required - Обязательный - Adjective
Fashionable - Модный - Adjective
Difficult - Трудный - Adjective
Shocking - Шокирующие, поразительный, возмутительный - Adjective
Unlikely - Маловероятно - Adjective
Financial - Финансовый - Adjective
Special - Особенный - Adjective
Sufficient - Достаточный - Adjective
Impolite - Невежливый - Adjective
Opaque - Непрозрачный - Adjective
Total - Полный, суммарный - Adjective
Old - Старый - Adjective
Negative - Отрицательная - Adjective
The worst - Самый худший - Adjective
Bilingual - Двуязычный - Adjective
Excellent - Отлично E - Adjective
Convenient - Подходящий - Adjective
Comfortable - Удобное - Adjective
Irrationally - Иррационально - Adjective
Possible - Возможно - Adjective
Unusual - Необычно - Adjective
Serious - Серьезный - Adjective
Fresh - Свежий - Adjective
Red - Красный - Adjective
Bloody - Кровавый - Adjective
Quickly - Быстро (Q) - Adjective
Cheap - Дешёвый - Adjective
Intermediate - Средний, промежуточный (уровень) - Adjective
Pure - Чистый - Adjective
Cold - Холодный - Adjective
Suspiciously - Подозрительно - Adjective
Fat - Толстый - Adjective
Frequent - частый - Adjective
Lonely - Одинокий - Adjective
Attractive - Привлекательный - Adjective
Weak - Слабый - Adjective
Thick - Толстый (книга) - Adjective
Bitterly - Горько - Adjective
Reliable - Надежный - Adjective
Bald - Лысый - Adjective
Sweet - Сладкий - Adjective
Great - Большая (британия), чудова - Adjective
Asleep - Спящий - Adjective
Economic - Экономический - Adjective
Annual - Ежегодный - Adjective
Former - Бывший - Adjective
Rarely - Редко - Adjective
Deep - Глубоко - Adjective
Urgently - Срочно - Adjective
Awesome - Прекрасно - Adjective
Wide - Широкий - Adjective
Late - опаздывающий, поздний, поздно - Adjective
The same - такой же, тот же - Adjective
Phenomenal - Феноменальный - Adjective
Sour - Кислый - Adjective
Quiet - Тихо - Adjective
Sore - Больной - Adjective
Likely - Вероятный - Adjective
Stylish - Стильная - Adjective
Curious - Любопытный - Adjective
Glad - Радостный, рад (видеть) - Adjective
Patient - Терпеливый, пациент - Adjective
Healthy - Здоровый - Adjective
Awake - Бодрствующий - Adjective
Elementary - Элементарный - Adjective
Redundant - Избыточный, уволенный - Adjective
Stateless - Лица без гражданства - Adjective
Inattentive - Невнимательный - Adjective
Exhausted - Измученный - Adjective
Outgoing - Общительный - Adjective
Concise - Краткий - Adjective
Consistent - Последовательный - Adjective
Extraneous - Посторонний - Adjective
Lazy - Ленивый - Adjective
Necessary - Необходимый - Adjective
Efficient - Эффективный - Adjective
Hard - Тяжёлый, жёсткий - Adjective
Upset - Расстроенный (U) - Adjective
Thirsty - Жаждущий - Adjective
Verbose - Подробный - Adjective
Arbitrary - Произвольный - Adjective
Awkward - Неуклюжий - Adjective
Silly - Глупый - Adjective
Neat - Аккуратный - Adjective
Exited - Взволнованный - Adjective
Previously - Ранее - Adjective
Suspicious - Подозрительно - Adjective
Long - Длинный - Adjective
Large - Большой - Adjective
Lower - Ниже - Adjective
Later - Позже - Adjective
Additional - Дополнительный - Adjective
Clear - Чистый, прозрачный - Adjective
Good - Хорошо - Adjective
Disappointed - Расстроенный - Adjective
Related - Связанная - Adjective
Outstanding - Выдающийся - Adjective
Worse - Хуже - Adjective
Used - Привыкший - Adjective
Whole - целый, весь - Adjective
Be able - быть в состоянии, мочь - Adjective
Similar - Похожий - Adjective
Thoroughly - Тщательно - Adjective
Unpredictable - Непредсказуемый - Adjective
Hospitable - Гостеприимный - Adjective
Powerful - Мощный - Adjective
Easily - легко, свободно - Adjective
Careful - Осторожно - Adjective
Pregnant - Беременна - Adjective
Previous - Предыдущий - Adjective
Lucky - Везучий - Adjective
Short - Короткий - Adjective
Strong - Сильный - Adjective
Sacred - Священный - Adjective
Accustomed - Привыкший - Adjective
Selfishly - Эгоистично - Adjective
Modern - Современный - Adjective
Able - Способный, мочь - Adjective
Skillful - Искусный - Adjective
The provided - Предоставленный - Adjective
Light - Более лёгкий, свет - Adjective
Crowded - Переполненный - Adjective
Richer - Богаче - Adjective
Worth - Ценность - Adjective
Social - Общественный - Adjective
Familiar - Знакомо - Adjective
Unique - Уникальная - Adjective
Unimportant - Не важный - Adjective
Sure - Уверен - Adjective
At last - Наконец - Adjective
Electric - Электрический - Adjective
Happy - Счастлив - Adjective
Slow - Медленный - Adjective
Sick - Больной - Adjective
Quietly - Тихо - Adjective
Smaller - Меньше (размер) - Adjective
Thrilling - Захватывающий - Adjective
Below average - Ниже среднего - Adjective
Terrible - Ужасный - Adjective
Better - Лучше - Adjective
More - Более - Adjective
Ready - Готовый - Adjective
Young - Молодой - Adjective
Main - Главный - Adjective
Bigger - Больше (размер) - Adjective
Prettier - Красивее - Adjective
Shy - Застенчивый - Adjective
Absolutely - Совершенно, Абсолютно - Adjective
Cleaner - Очиститель - Adjective
Bad - Плохой - Adjective
Cheaper - Дешевле - Adjective
Comparable - Сопоставимый - Adjective
Most - Наиболее - Adjective
Dying - Умирающий - Adjective
Clean - Чистый - Adjective
Hidden - Скрытый - Adjective
Immediately - Сразу - Adjective
Quite seldom - Достаточно редко - Adjective
Older - Старше (возраст) - Adjective
Full of - Полон чего - Adjective
Beautiful - Красивый - Adjective
Black - Чёрный - Adjective
Available - Доступен - Adjective
Regular - обычный - Adjective
Global - Глобальный - Adjective
Orange - Оранжевый - Adjective
Wild - Дикий - Adjective
Colorful - Блестящий - Adjective
fiddly - неуклюжий - Adjective
Sad - Грустный - Adjective
Next - Следующий - Adjective
Internal - Внутренний - Adjective
Higher - Выше чем - Adjective
Probable - Вероятный - Adjective
Correctly - Правильно - Adjective
Pleasent - Приятный - Adjective
Dressed - Одетый - Adjective
Empty - Пустой - Adjective
Innocent - невиновный - Adjective
Unclear - Не понятно - Adjective
Opposite - Противоположные - Adjective
Well - Хорошо - Adjective
Green - Зелёный - Adjective
Entirely - Полностью - Adjective
Peaceful - Мирный - Adjective
Grey - Серый - Adjective
Fluently - Свободно - Adjective
Average - Средний - Adjective
Idle - Праздный - Adjective
True - Истинный - Adjective
Real - Реальный - Adjective
Brightly - Ярко - Adjective
Focused - Сосредоточенный - Adjective
Small - Маленький - Adjective
Underlying - Лежащий в основе - Adjective
Absent - Отсутствующий - Adjective
Sincere - Искренне - Adjective
Explicitly - Явно - Adjective
Humble - Скромный - Adjective
Implicit - Скрытый - Adjective
Slim - Стройный - Adjective
Alive - Живой - Adjective
Sparingly - Скудно - Adjective
Thoughtful - Задумчивый - Adjective
Versus - Против - Adjective
Properly - Правильно - Adjective
External - Внешний - Adjective
Conflated - Смешанный - Adjective
Intimidating - Пугающий - Adjective
Sequentially - Последовательно - Adjective
Fake - Поддельный - Adjective
Mutable - Изменчивый - Adjective
Mad - Безумный - Adjective
Disambiguation - Неоднозначный - Adjective
Amazed by - Поражён - Adjective
Essential - необходимый, обязательный - Adjective
Unlike - Маловероятно - Adjective
Accurately - Точно - Adjective
Free - (быть) свободным - Adjective
Mutual - Общий - Adjective
Briefly - Кратко - Adjective
Unfairly - Несправедливо - Adjective
Polite - Вежливый - Adjective
Incompatible - Несовместимый - Adjective
Appealing - Привлекательный - Adjective
Calm - Спокойный - Adjective
Roughly - Грубо - Adjective
Fairly - Справедливо - Adjective
Appropriate - Соответствующий - Adjective
Correct - Правильный - Adjective
Fragile - Хрупкий - Adjective
Recent - Свежая (газета) - Adjective
Brief - Краткий - Adjective
Harassed - Измученный - Adjective
Tiny - Крошечный - Adjective
Used to - Привыкший к - Adjective
Narrow - Узкий - Adjective
Amazing - Удивительный - Adjective
Tall - Высокий - Adjective
Profoundly - Глубоко, основательно - Adjective
Obsolete - Устаревший - Adjective
Quick - Быстрый - Adjective
Blank - Пустой - Adjective
Rare - Редкий - Adjective
Immutable - Неизменный - Adjective
Different - Другой, разные - Adjective
Silent - Тихий - Adjective
NOT bound - НЕ привязан - Adjective
Premature - Преждевременный - Adjective
Thin - Тонкий (книга) - Adjective
Handsome - Красивый - Adjective
High - Высокий - Adjective
Slightly - Немного - Adjective
Weird - Странный - Adjective
Profound - Глубокий - Adjective
Considerably - Значительно (С) - Adjective
Subtle - Тонкий - Adjective
Sequential - Последовательный - Adjective
Complex - Комплексный - Adjective
Obliging - Обязательный - Adjective
Infinite - Бесконечный - Adjective
Complicated - Сложный - Adjective
Compound - Составной - Adjective
Separate - Отдельный - Adjective
Confident - уверенный - Adjective
Proven - Проверенный - Adjective
Exhaustive - Исчерпывающий - Adjective
Nested - Вложенный - Adjective
Eloquent - Красноречивый - Adjective
Repetitive - Повторяющийся - Adjective
Happily - Счастливо - Adjective
Inversely - Обратно - Adjective
Past - Прошлое - Adjective
Spacious - Просторная - Adjective
Inflexible - Негибкий - Adjective
Revised - Повторённый, пересмотренный - Adjective
Following - Следующие (ошибки) - Adjective
Sharp - Острый - Adjective
Younger - Младше - Adjective
Heavy - Тяжёлый - Adjective
Huge - Огромный - Adjective
Regarding - Касательно - Adjective
Incurable - Неизлечимо - Adjective
Curable - Излечимый - Adjective
Significantly - Значительно (S) - Adjective
Yellow - Жёлтый - Adjective
Wrong - Неправильный - Adjective
Usual - Обычный - Adjective
Impossible - Невозможно - Adjective
Lost - потерянный, пропавший - Adjective
Pink - Розовый - Adjective
Sudden - Внезапный - Adjective
Low - Низкий - Adjective
Tremendous - Огромный, потрясающий - Adjective
Prestigious - Престижно - Adjective
Certain - Уверенный - Adjective
Nice - Красивый, хороший - Adjective
Soft - Мягкий - Adjective
Seldom - Редко - Adjective
Distinct - Особый - Adjective
White - Белый - Adjective
Final - Последний, решающий - Adjective
Courageously - Отважно - Adjective
Warm - Тёплый - Adjective
Handy - Удобный - Adjective
Temporary - Временный - Adjective
Round - Круглый - Adjective
Compatible - Совместимы - Adjective
Simultaneously - Одновременно - Adjective
Simultaneous - Одновременный - Adjective
Rude - Грубый - Adjective
Willing - Готовый - Adjective
Explicit - Явный - Adjective
Strange - Странный - Adjective
Crucial - Решающий - Adjective
Overall - Всеобщий - Adjective
Heroical - Героический - Adjective
Entire - Весь - Adjective
Counterintuitive - Нелогичный - Adjective
The highest - Самый высокий - Adjective
Widespread - Широко распространен - Adjective
Heroically - Героически - Adjective
Easy - Легко, лёгкий, спокойно  - Adjective
Unaware - Не подозревающий - Adjective
Inadvertent - Непреднамеренный - Adjective
Anywhere - Где угодно - Adverb
Furthermore - Более того - Adverb
Fortunately - К счастью - Adverb
Already - Уже - Adverb
Warmly - Тепло - Adverb
Otherwise - В противном случае - Adverb
Partly - Частично - Adverb
Twice - Дважды - Adverb
Deliberately - Преднамеренно - Adverb
Cheaply - Дешево - Adverb
Arguably - Возможно - Adverb
Although - Хотя - Adverb
Ago - Назад (час назад) - Adverb
Greatly - Очень сильно - Adverb
Rather - Скорее - Adverb
Particularly - Особенно - Adverb
Directly - Напрямую - Adverb
Backward - Обратно - Adverb
Carefully - Осторожно, внимательно, бережно - Adverb
Always - Всегда - Adverb
Somehow - Как то - Adverb
Further - Дальше - Adverb
Exactly - Точно! , конкретнее - Adverb
Perfectly - совершенно, вполне - Adverb
Together - Вместе - Adverb
Definitely - Точно!, Определенно, разумеется! - Adverb
Above - Выше (среднего) - Adverb
Enough - Достаточно - Adverb
Now - Сейчас - Adverb
Just - Только, просто, только что - Adverb
Precisely - Конкретно - Adverb
Almost - Майже, почти - Adverb
Yesterday - Вчера - Adverb
Luckily - К счастью - Adverb
Frankly - Честно? - Adverb
Indeed - Действительно - Adverb
Down - Вниз - Adverb
Approximately - Приблизительно - Adverb
Honestly - Честно? - Adverb
Really - Действительно - Adverb
Today - Сегодня - Adverb
Maybe - Может быть - Adverb
Regardless - Несмотря ни на что - Adverb
Least - Наименее, как минимум - Adverb
Expectedly - Ожидаемо - Adverb
Suddenly - Вдруг, внезапно - Adverb
Occasionally - Изредка - Adverb
Very - Очень - Adverb
Never - Никогда - Adverb
Perhaps - Возможно - Adverb
Frequently - Часто - Adverb
Especially - Особенно, специально - Adverb
Whence - Откуда - Adverb
Completely - Полностью - Adverb
Nowhere - Нигде - Adverb
Then - Тогда - Adverb
Periodically - Периодически - Adverb
Solely - Исключительно - Adverb
Tomorrow - Завтра - Adverb
Any more - Некогда больше - Adverb
Hence - Следовательно - Adverb
Therefore - Поэтому - Adverb
Fully - Полностью - Adverb
Merely - Просто - Adverb
Nearly - Около - Adverb
Unless the - Если только - Adverb
Pretty - Довольно, красиво - Adverb
Also - Также - Adverb
Relatively - Относительно - Adverb
Eventually - В конечном итоге - Adverb
Below - Ниже (среднего) - Adverb
Often - Часто - Adverb
Finally - Наконец (F) - Adverb
Only - Только - Adverb
Everywhere - Везде - Adverb
Forward - Вперёд - Adverb
Certainly - Конечно (C) - Adverb
Most of all - Больше всего - Adverb
Differently - По другому - Adverb
Again - Снова - Adverb
However - Однако - Adverb
Soon - Скоро - Adverb
Tonight - Сегодня вечером - Adverb
Even - Даже - Adverb
Tongue - Язык - Body
Feet - Стопы - Body
Chest - Грудь - Body
Legs - Ноги - Body
Wing - Крыло - Body
Mouth - Рот - Body
Face - Лицо - Body
Brain - Мозг - Body
Blood - Кровь - Body
Neck - Шея - Body
Head - Голова - Body
Hand - Рука - Body
Ridge - Хребет - Body
Foot - Нога - Body
Hair - Волосы - Body
Body - Тело - Body
Nose - Нос - Body
Soul - Душа - Body
Mind - Разум - Body
Finger - Палец - Body
Eye - Глаз - Body
Heart - Сердце - Body
Skin - Кожа - Body
Take off - Снимать (одежду) - Clothes
Trousers - Брюки - Clothes
Pocket - Карман - Clothes
While - В то время - Conjunction
Friendly - Дружелюбный - Duolingo
Still - Все еще - Flag present continues
Currently - В настоящее время - Flag present continues
Listen! - Слушай! - Flag present continues
Look! - Смотри! - Flag present continues
At present - В настоящий момент - Flag present continues
Nowadays - Настоящее время - Flag present continues
Fruit - Фрукт - Food
Lemon - Лимон - Food
Milk - Молоко - Food
Cake - Пироженое - Food
Pasta - Макароны - Food
Dinner - Ужин - Food
Meat - Мясо - Food
Cheese - Сыр - Food
Juice - Сок - Food
Bottle - Бутылка - Food
Beer - Пиво - Food
Breakfast - Завтрак - Food
Soup - Суп - Food
Bread - Хлеб - Food
Sugar - Сахар - Food
Lunch - Обед - Food
Tea - Чай - Food
Cherry - Вишня - Food
Food - Еда - Food
Floor - Пол - Home
Marriage - Свадьба - Home
Miss - Соскучиться (за кем то) - Home
Clothes - Одежда - Home
Health - Здоровье - Home
Flat - Квартира - Home
Wonderful - Замечательный, чудесный - Home
Apartment - Квартира (A) - Home
Single - Один - Home
Toothbrush - Зубная щётка - Home
Bruh - Братан - Home
Poor - Бедный - Home
Feeling - Чувство - Home
Train - Тренировка - Home
Worry - Беспокоить, волноваться - Home
Chair - Стул - Home
Married - Женат - Home
Adult - Взрослый - Home
Funny - Забавно - Home
Eyes - Глаза - Home
Birthday - День рождения - Home
Grown Up - Взрослый - Home
Guest - Гость - Home
Jug - Кувшин - Home
Ands - Заканчивается - Idiom
How much - Сколько (денег) - Idiom
Make made made - Делать - Irregular verb
Sink sank sunk - Тонуть - Irregular verb
Cost cost cost - Стоить - Irregular verb
Catch caught caught - Ловить - Irregular verb
Sit sat sat - Сидеть - Irregular verb
Stand stood stood - Встать (он встал) - Irregular verb
Fall fell fallen - Упал - Irregular verb
Read read read - Читать - Irregular verb
Lose lost lost - Терять - Irregular verb
Meet met met - Встречать - Irregular verb
Win won won - Выигрывать - Irregular verb
Have had had - Иметь - Irregular verb
Set set set - Установить - Irregular verb
Sweep swept swept - Подметать - Irregular verb
Shake shook shaken - Трясти - Irregular verb
Overtake overtook overtaken - Обгонять - Irregular verb
Learn learnt learnt - Учить (учится) - Irregular verb
Rewrite rewrote rewritten - Переписать - Irregular verb
Stick stuck stuck - Приклеивать - Irregular verb
Mislead misled misled - Ввести в заблуждение - Irregular verb
Prove proved proved - Доказать - Irregular verb
Misspell misspelt misspelt - Опечатываться - Irregular verb
Allow allowed allowed - Разрешить (A) - Irregular verb
Dive dove dived - Нырять - Irregular verb
Wear wore worn - Носить (одежду) - Irregular verb
Can could - Могу, умею - Irregular verb
Retell retold retold - Пересказывать - Irregular verb
Undertake undertook undertaken - Предпринимать - Irregular verb
Swear swore sworn - Клясться - Irregular verb
Rebuild rebuilt rebuilt - Перестроить - Irregular verb
Forbid forbade forbidden - Запрещать - Irregular verb
Bear bore borne - Терпеть - Irregular verb
Lend lent lent - Одолжить (кому то) - Irregular verb
Freeze froze frozen - Заморозить - Irregular verb
Cut cut cut - Резать - Irregular verb
Death died die - Умер - Irregular verb
Light lit lit - Зажечь - Irregular verb
Think thought thought - Думать - Irregular verb
Give gave given - Дать - Irregular verb
Undergo underwent undergone - Подвергаться - Irregular verb
Hit hit hit - Ударить - Irregular verb
Fly flew flown - Летать - Irregular verb
Say said said - Сказал - Irregular verb
Teach taught taught - Преподавать - Irregular verb
Underpay underpaid underpaid - Недоплачивать - Irregular verb
Draw drew drawn - Рисовать - Irregular verb
Misunderstand misunderstood misunderstood - Неправильно понять - Irregular verb
Broadcast broadcast broadcast - Транслировать - Irregular verb
Deal dealt dealt - Иметь дело - Irregular verb
Know knew known - Знать - Irregular verb
Spend spent spent - Тратить - Irregular verb
Leave Left Left - Оставил, покинул - Irregular verb
Put put put - Положить - Irregular verb
Sleep slept slept - Спать - Irregular verb
Tear tore torn - Рвать - Irregular verb
Choose chose chosen - Выбирать - Irregular verb
Go went gone - Идти - Irregular verb
Lie lied lied - Врать (не путать с лежать) - Irregular verb
Buy bought bought - Покупать - Irregular verb
Ride rode ridden - Водить, ехать - Irregular verb
Dream dreamt dreamt - Мечтать - Irregular verb
Spoil spoilt spoilt - Портить - Irregular verb
Bite bit bitten - Кусать - Irregular verb
Fight fought fought - Сражаться - Irregular verb
Show showed shown - Показывать - Irregular verb
Lay laid laid - Класть - Irregular verb
Hang hung hung - Вешать - Irregular verb
Rise rose risen - Вставать, подъем (сонце) - Irregular verb
Redo redid redone - Переделать - Irregular verb
Send sent sent - Отправлять - Irregular verb
Become became become - Стал - Irregular verb
Fit fit fit - Подходит (идёт) - Irregular verb
Break broke broken - Ломать - Irregular verb
Hear heard heard - Слышать - Irregular verb
Oversleep overslept overslept - Проспать - Irregular verb
Keep kept kept - Хранить - Irregular verb
Take took taken - Брать - Irregular verb
Wake woke waken - Просыпаться - Irregular verb
Throw threw thrown - Бросать - Irregular verb
Blow blew blown - Дуть - Irregular verb
Get got got - Получать - Irregular verb
Hide hid hidden - Прятать - Irregular verb
Sell sold sold - Продать - Irregular verb
Sing sang sung - Петь - Irregular verb
Mean meant meant - Иметь в виду (означать) - Irregular verb
Dig dug dug - Рыть - Irregular verb
Foresee foresaw foreseen - Предвидеть - Irregular verb
Eat ate eaten - Есть, кушать - Irregular verb
Tell told told - Говорить кому то - Irregular verb
Run ran run - Бежать - Irregular verb
Overeat overate overeaten - Переедать - Irregular verb
See saw seen - Видеть - Irregular verb
Withdraw withdrew withdrawn - Снять деньги - Irregular verb
Do did done - Делать - Irregular verb
Be was were been - Быть - Irregular verb
Smell smelt smelt - Пахнуть - Irregular verb
Forget forgot forgotten - Забывать - Irregular verb
Let let let - Позволить - Irregular verb
Shoot shot shot - Стрелять - Irregular verb
Bring brought brought - Принести - Irregular verb
Speak spoke spoken - Разговаривать (говорить) - Irregular verb
Steal stole stolen - Украсть - Irregular verb
Forgive forgave forgiven - Прощать - Irregular verb
Drive drove driven - Ехать - Irregular verb
Feed fed fed - Кормить - Irregular verb
Feel felt felt - Чувствовать - Irregular verb
Hurt hurt hurt - Обижать, задеть, слегка повредить - Irregular verb
Find found found - Найти - Irregular verb
Overcome overcame overcome - Преодолеть - Irregular verb
Split split split - Расставаться - Irregular verb
Hold held held - Держать в руках - Irregular verb
Burn burnt burnt - Гореть - Irregular verb
Swim swam swum - Плавать - Irregular verb
Ring rang rung - Звонить - Irregular verb
Understand understood understood - Понимать - Irregular verb
Overpay overpaid overpaid - Переплатить - Irregular verb
Lie lay lain - Лежать - Irregular verb
Begin began begun - Начинать - Irregular verb
Drink drank drunk - Пить - Irregular verb
Grow grew grown - Расти, выращивать - Irregular verb
Write wrote written - Писать - Irregular verb
Pay paid paid - Платить - Irregular verb
May - Мочь - Modal verb
Can - Может - Modal verb
Must - Должен - Modal verb
Might - Возможно - Modal verb
Should - Следует - Modal verb
Ought to - Следует - Modal verb
Shall - Должен - Modal verb
Star - Звезда - Nature
Family - Семья - Nature
Animal - Животное - Nature
Lion - Лев - Nature
Rain - Дождь - Nature
Husband - Муж, супруг - Nature
People - Люди - Nature
Sister - Сестра - Nature
Sky - Небо - Nature
Ice - Лёд - Nature
Chicken - Курица, цыплёнок - Nature
Goose - Гусь - Nature
Color - Цвет - Nature
Cat - Кошка - Nature
Shit - Дерьмо - Nature
Beach - Пляж - Nature
Man - Человек, мужик - Nature
Horse - Лошадь - Nature
Egg - Яйцо - Nature
Dolphin - Дельфин - Nature
Wolf - Волк - Nature
Ground - Земля - Nature
Elephant - Слон - Nature
Person - Человек - Nature
Rat - Крыса - Nature
Girlfriend - Невеста - Nature
Boyfriend - Парень (её) - Nature
Duck - Утка - Nature
Snow - Снег - Nature
Tsunami - Цунами - Nature
Water - Вода - Nature
Zoo - Зоопарк - Nature
Moon - Луна - Nature
Tree - Дерево - Nature
Air - Воздух - Nature
Mouse - Мышь - Nature
Weather - Погода - Nature
Fish - Рыба - Nature
Waterfall - Водопад - Nature
Tiger - Тигр - Nature
Lake - Озеро - Nature
Monkey - Обезьяна - Nature
Pig - Свинья - Nature
Mom - Мама - Nature
Engineer - Инженер - Nature
Forest - Лес - Nature
Spider - Паук - Nature
Camel - Верблюд - Nature
Death - Смерть - Nature
Son - Сын - Nature
Child - Ребёнок - Nature
Bear - Медведь - Nature
Friend - Друг - Nature
Sir - Сэр - Nature
Flower - Цветок - Nature
Bull - Бык - Nature
Parent - Родитель - Nature
Mother - Мать - Nature
Cow - Корова - Nature
Fox - Лиса - Nature
Eagle - Орёл - Nature
Wife - Жена - Nature
Stone - Камень - Nature
Baby - Крошка - Nature
Wind - Ветер - Nature
Enemy - Враг - Nature
Woman - Женщина - Nature
Bird - Птица - Nature
Dog - Собака - Nature
Grass - Трава - Nature
Word - Слово - Noun
Disadvantage - Недостаток - Noun
Clarification - Уточнение - Noun
Grief - Горе - Noun
Closet - Шкаф - Noun
Supper - Ужин - Noun
Failure - Провал - Noun
Exit_1 - Выход - Noun
Woods - Лес - Noun
Concision - Краткость - Noun
Court - Суд - Noun
Universe - Вселенная - Noun
Belief - Вера - Noun
Favor - Одолжение - Noun
Shelf - Полка - Noun
Violin - Скрипка - Noun
Tie - Галстук - Noun
Fair - Ярмарка, честно, справедливо - Noun
Center - Центр - Noun
Term - Срок - Noun
Symbol - Символ - Noun
Responsibility - Ответственность - Noun
A change of clothes - Сменная одежда - Noun
Fashion - Мода - Noun
Conclusion - Вывод - Noun
Palm - Ладонь - Noun
Judgement - Суждение - Noun
Scope - Объем - Noun
Scientists - Учёный - Noun
Pea - Горох - Noun
Volcano - Вулкан - Noun
Formation - Образование, Формирование - Noun
Peace - Мир - Noun
Instance - Пример - Noun
Safety - Безопасность - Noun
Header - Заголовок - Noun
Campaign - Компания - Noun
Science - Наука - Noun
Navy - Флот - Noun
Distance - Расстояние - Noun
Chemistry - Химия - Noun
Government - Правительство - Noun
Spelling - Правописание - Noun
Conversation - Разговор - Noun
Ghost - Привидение - Noun
Wealth - Богатство - Noun
Insurance - Страховка - Noun
Limit - Граница - Noun
Debts - Долги - Noun
Parliament - Парламент - Noun
Writing - Письмо, написание - Noun
Definition - Определение - Noun
Leader - Лидер - Noun
Volume - Объём - Noun
Laws - Законы - Noun
Freedom - Свобода - Noun
Dot - Точка - Noun
Members - Участники - Noun
Quality - Качество - Noun
Middle - Середина - Noun
Taxes - Налоги - Noun
Temperature - Температура - Noun
Surface - Поверхность - Noun
Technique - Техника - Noun
Advantage - Преимущество - Noun
Schedule - График - Noun
Investment - Инвестиция - Noun
Reply - Ответ (реплика) - Noun
Mass - Масса - Noun
Univers - Вселенная - Noun
Invitation - Приглашение - Noun
Vote - Голос - Noun
Speed - Скорость - Noun
Violence - Насилие - Noun
Formula - Формула - Noun
Army - Армия - Noun
Depth - Глубина - Noun
Strategy - Стратегия - Noun
Sample - Пример - Noun
Timetable - Расписание - Noun
Notification - Уведомление - Noun
Power - Власть - Noun
Computer science - Информатика - Noun
Publication - Издание - Noun
Thief - Вор - Noun
Task - Задача - Noun
Saint - Святой - Noun
Tend - Тенденция - Noun
Victory - Победа - Noun
Singer - Певец - Noun
Crime - Преступление - Noun
Beauty - Красота - Noun
Attention - Внимание - Noun
Midnight - Полночь - Noun
Direction - Инструкция, направление - Noun
Effort - Усилие - Noun
Efforts - Усилия - Noun
Enthusiasm - Энтузиазм - Noun
Arm - Рука - Noun
Entrance - Вход - Noun
Exist - Существовать - Noun
Gas - Газ - Noun
Field - Поле - Noun
Gasoline - Бензин - Noun
Theater - Театр - Noun
Earth - Земля - Noun
Damage - Повреждение - Noun
Courage - Отвага - Noun
Age - Возраст - Noun
Subject - Предмет - Noun
Discount - Скидка - Noun
Masterpiece - Шедевр - Noun
School uniform - Школьная форма - Noun
Fire - Огонь - Noun
Parcel - Посылка - Noun
Crop - Урожай - Noun
Cousin - Двоюродный брат - Noun
Track - Путь - Noun
Existence - Существование - Noun
Flute - Флейта - Noun
Title - Название - Noun
Promise - Обещание - Noun
Trend - Тенденция - Noun
Dust - Пыль - Noun
Danger - Опасность - Noun
Thought - Мысль - Noun
Customer - Покупатель - Noun
Truth - Правда - Noun
Avenue - Проспект - Noun
Vegetables - Овощи - Noun
Razor - Бритва - Noun
Entry - Вход - Noun
Space - Космос, пространство - Noun
Wheel - Колесо - Noun
Hook - Крюк - Noun
Shirt - Рубашка - Noun
Pen - Ручка - Noun
Report - Отчёт - Noun
Jacket - Куртка, пиджак - Noun
Door - Дверь - Noun
North - Север - Noun
Front - перед, передняя часть - Noun
Window - Окно - Noun
Ship - Корабль - Noun
Visa - Виза - Noun
Car - Автомобиль - Noun
Game - Игра - Noun
Description - Описание - Noun
Leg - Нога - Noun
Vehicle - Транспорт - Noun
Sibling - брат или сестра - Noun
Edition - Издание - Noun
Manner - Манера - Noun
Thing - Вещь - Noun
Scissors - Ножницы - Noun
Mail - Почта - Noun
Toilet - Туалет - Noun
Sales - Продажи - Noun
App - Приложение - Noun
Toy - Игрушка - Noun
Appearance - Внешность - Noun
Square - Площадь - Noun
Majority - Большинство - Noun
Blame - Вина - Noun
Activity - Деятельность - Noun
Fault - Вина - Noun
Purpose - Цель - Noun
Valley - Долина - Noun
Business card - Визитка - Noun
Powder - Порошок - Noun
Cabinet - Шкаф - Noun
Anniversary - Годовщина - Noun
Top - Верх - Noun
Bag - Сумка - Noun
Bed Sheet - Простынь - Noun
Way - Путь - Noun
Community - Общество - Noun
Street - Улица - Noun
Job - Работа - Noun
Agent - Агент - Noun
Budget - Бюджет - Noun
Topic - Тема - Noun
Gold - Золото - Noun
Assistant - Ассистент - Noun
Spoon - Ложка - Noun
Bicycle - Велосипед - Noun
Taxi - Такси - Noun
Option - Вариант - Noun
Region - Район - Noun
Board - Доска - Noun
Currency - Валюта - Noun
Question mark - Вопросительный знак - Noun
Contract - Контракт - Noun
Sofa - Диван - Noun
Luck - Удача - Noun
Box - Коробка - Noun
Pan - Сковорода - Noun
Clock - Часы - Noun
The staff - Сотрудники (команда) - Noun
Route - Маршрут - Noun
Tower - Башня - Noun
Worker - Рабочий - Noun
Prison - Тюрьма - Noun
Hospital - Больница - Noun
Industry - Промышленность - Noun
Goods - Товары - Noun
Departure - отправление, вылет - Noun
The couple - Эти женатики (пара) - Noun
Fork - Вилка - Noun
Joke - Шутка - Noun
Yard - Улица, двор - Noun
God - Бог - Noun
Motorcycle - Мотоцикл - Noun
Ball - Мяч - Noun
Hotel - Отель - Noun
Bowl - Миска - Noun
Chain - Цепь - Noun
Capital - Столица - Noun
Castle - Замок - Noun
Size - Размер - Noun
Painter - Художник - Noun
Journey - Поездка - Noun
Amount - Количество (a) - Noun
Youth - Молодежь - Noun
Artist - Художник - Noun
Uncle - Дядя - Noun
Trouble - Проблема - Noun
Afternoon - вторая половина дня - Noun
Airplane - Самолет - Noun
String - Нитка, шнурок - Noun
Opportunity - Возможность - Noun
Boat - Лодка - Noun
Novel - Роман - Noun
Victim - Жертва - Noun
Knife - Нож - Noun
Root - Корень - Noun
Prize - Приз - Noun
Degree - Научная степень - Noun
Company - Компания - Noun
Subway - Метро - Noun
Money - Деньги - Noun
Bell - Звон, колокол - Noun
Noise - Шум - Noun
Organization - Организация - Noun
Traffic - Пробки (на дорогах) - Noun
Bed - Кровать - Noun
Book - Книга - Noun
Theory - Теория - Noun
Analysis - Анализ - Noun
Pronunciation - Произношение - Noun
House - Дом - Noun
Technology - технология - Noun
Country - Страна - Noun
Devil - Дьявол - Noun
Textbook - Учебник - Noun
Scale - Шкала - Noun
Occasion - Повод - Noun
Skills - Навыки - Noun
Trade - Торговля - Noun
The way - Путь - Noun
The window - Окно - Noun
Physics - Физика - Noun
Fortune - Удача, случай - Noun
Song - Песня - Noun
Explanation - Объяснения - Noun
Flight - Полет, рейс - Noun
Comb - Гребешок - Noun
Difference - Разница - Noun
Teacher - Учитель - Noun
Theories - Теории - Noun
Village - Село - Noun
Sheet - Лист, страница - Noun
Sponge - Губка - Noun
Teeth - Зубы - Noun
Cycle - Цикл - Noun
Action - Поступок - Noun
School - Школа - Noun
Actions - Поступки - Noun
Salary - Зарплата - Noun
Criminal - Преступник - Noun
Objective - Цель (O) - Noun
Agreement - Договоренность - Noun
Importance - Важность - Noun
Boy - Мальчик - Noun
Town - Город (T) - Noun
Place - Место - Noun
Policeman - Полицейский - Noun
Pool - Бассейн - Noun
Phrase - Фраза - Noun
West - Запад - Noun
Advertising - Реклама - Noun
Party - Вечеринка - Noun
Shop - Магазин - Noun
Promotion - Повышение - Noun
Reason - Причина - Noun
Silver - Серебро - Noun
Approach - Подход - Noun
Birth - Рождение - Noun
Introduction - Вступление - Noun
Neighborhood - Район - Noun
Daughter - Дочь - Noun
Statement - Утверждение, Заявление - Noun
Guide - Гид - Noun
Passion - Страсть - Noun
The end - Конец - Noun
Waiter - Официант - Noun
Effect - Последствия - Noun
Personality - характер - Noun
Desk - Письменный стол - Noun
Tale - Сказка - Noun
Holiday - Отпуск - Noun
Suitcase - Чемодан - Noun
Border - Граница - Noun
Wall - Стена - Noun
Hell - Ад - Noun
Mover - Двигатель - Noun
Soap - Мыло - Noun
Soldier - Солдат - Noun
Key - Ключ - Noun
Nickname - Прозвище - Noun
World - Мир - Noun
Queen - Королева - Noun
Evidence - Доказательство - Noun
Skirt - Юбка - Noun
Stage - Стадия - Noun
Basket - Корзина - Noun
Engine - Двигатель - Noun
Award - Награда - Noun
Motor - Двигатель - Noun
Lawyer - Юрист - Noun
Aunt - Тетка - Noun
Authorities - Власти - Noun
Disease - Болезнь (тяжелая) - Noun
Notebook - Тетрадь - Noun
Length - Длинна, продолжительность - Noun
Native speaker - Носитель языка - Noun
Half - Половина - Noun
Garden - Сад - Noun
Grade - Оценка - Noun
Leaf - Лист - Noun
Trip - Поездка - Noun
King - Король - Noun
Father - Отец - Noun
Life - Жизнь - Noun
Exception - Исключение - Noun
Abilities - Способности - Noun
Island - Остров - Noun
Coin - Монета - Noun
Picture - Картинка - Noun
Question - Вопрос - Noun
Citizen - Гражданин - Noun
Load - Груз - Noun
Threat - Угроза - Noun
Library - Библиотека - Noun
Fear - Страх - Noun
Treatment - Лечение - Noun
Directions - Инструкции - Noun
Argument - Спор - Noun
Ears - Уши, слушать - Noun
Room - Комната - Noun
Goal - Цель - Noun
Ring - Кольцо - Noun
Bathroom - Ванная - Noun
Duty - Долг - Noun
Paradise - Рай - Noun
Protection - Защита - Noun
Area - Область, район - Noun
Page - Страница - Noun
Plate - Тарелка - Noun
Joi - Радость - Noun
Mistake - Ошибка - Noun
Language - Язык - Noun
Faith - Вера - Noun
Marathon - Марафон - Noun
Lady - дама - Noun
Price - Цена - Noun
Thoughts - Мысли - Noun
Desire - Желание - Noun
Threshold - Порог - Noun
Cup - Чашка - Noun
Humor - Настроение - Noun
Pain - Боль - Noun
Equipment - Оборудование - Noun
Difficulties - Сложности - Noun
Discussion - Обсуждение - Noun
Button - Кнопка - Noun
Kitchen - Кухня - Noun
Lesson - Урок - Noun
Coast - Берег - Noun
Farm - Ферма - Noun
Laundry - Прачечная - Noun
Research - Дослідження - Noun
Scientist - Ученый - Noun
Firm - Фирма - Noun
Differences - Отменности - Noun
Market - Рынок - Noun
Table - Стол - Noun
Bus - Автобус - Noun
Mayor - Мэр - Noun
Script - Сценарий - Noun
Climate - Климат - Noun
Virusis - Вирус - Noun
Wedding - Свадьба - Noun
Nephew - Племянник - Noun
Permit - Разрешение, пропуск - Noun
Drug - Лекарства, наркотики - Noun
Ear - Ухо - Noun
Accident - Происшествие - Noun
Demand - Спрос - Noun
Advice - Совет - Noun
Cause - Причина - Noun
Relations - Связи - Noun
Possibility - Возможность - Noun
District - Район - Noun
Relationship - Отношения - Noun
Mirror - Зеркало - Noun
Vision - Зрение - Noun
Ambulance - Скорая помощь - Noun
Virus - Вирус - Noun
Channel - Канал - Noun
Home - Дом - Noun
Net - Сеть - Noun
Diet - Диета - Noun
Refusal - Отказ - Noun
Jewelry - Украшения - Noun
Measure - Мера - Noun
Roof - Крыша - Noun
Investigation - Дослідження - Noun
In trouble - В беде - Noun
Intention - Намерение - Noun
Signature - Подпись - Noun
Rock - Камень - Noun
Viruses - Вирусы - Noun
Relation - Связь - Noun
Appointment - встреча - Noun
Guilt - Вина - Noun
Interest - Процент - Noun
Athlete - Атлет - Noun
Paint - Краска - Noun
Band - Группа - Noun
Team - Команда - Noun
Plant - Растение - Noun
Achievement - Достижение - Noun
Actress - Актриса - Noun
Aim - Цель - Noun
Vacation - Отпуск - Noun
Construction - Стройка - Noun
Choice - Выбор - Noun
Permission - Разрешение - Noun
Honor - Честь - Noun
Confidence - Уверенность - Noun
Audience - Аудитория - Noun
Captain - Капитан - Noun
Cloud - Облако - Noun
Emergency - Чрезвычайная ситуация - Noun
Acquaintance - Знакомый - Noun
Heat - Жара - Noun
Concept - Понятие - Noun
Performance - Выступление - Noun
Character - Характер - Noun
Attempt - Попытка - Noun
Countdown - Обратный отсчет - Noun
Rectangle - Прямоугольник - Noun
Quizz - Викторина - Noun
Landscape - Ландшафт - Noun
Part - Часть - Noun
Search - Поиск - Noun
Murder - Убийство - Noun
Joy - Радость - Noun
Land - Земля, родина, хз - Noun
Lack - Нехватка, недостаток - Noun
Origin - Происхождение, источник - Noun
Piece - Кусок - Noun
Shadow - Тень - Noun
Reality - Реальность - Noun
Press - Пресса - Noun
Production - Производство - Noun
Sensation - Сенсация - Noun
The amount - Количество - Noun
Review - Обзор - Noun
Outside - Снаружи - Noun
Service - Услуга - Noun
License - Разрешение - Noun
Mountain - Гора - Noun
Poetry - Поэзия - Noun
Literature - Литература - Noun
Path - Путь - Noun
Sequence - Последовательность - Noun
Painting - Картина - Noun
Circle - Круг - Noun
Position - Должность - Noun
Composition - Сочинение - Noun
Nature - Природа - Noun
Item - Элемент - Noun
Network - Сеть - Noun
Screen - Экран - Noun
Binding - Связывание - Noun
Shape - Форма (состояние) - Noun
Equality operator - Оператор равенства - Noun
Injury - Травма - Noun
Pleasure - Удовольствие - Noun
Response - Ответ - Noun
Postcard - Открытка - Noun
Smoke - Дым - Noun
Religion - Религия - Noun
Pond - Пруд - Noun
Sight - Зрение, взгляд - Noun
Sand - Песок - Noun
Fact - Факт - Noun
Diamonds - Бубна (карты) - Noun
Weapon - Оружие - Noun
Soil - Земля - Noun
Fun - Веселье - Noun
Club - Дубина - Noun
Outcome - Результат, Исход - Noun
Toes - Пальци на ноге - Noun
War - Война - Noun
Patience - Терпение - Noun
Art - Искусство - Noun
Intruder - Нарушитель - Noun
River - Река - Noun
Content - Состав - Noun
Ways - Способы - Noun
Sea - Море - Noun
Harm - Вред - Noun
Pie - Пирог - Noun
Application - Заявка - Noun
Cancer - Рак - Noun
Hole - Яма - Noun
Bedroom - Спальня - Noun
Tears - Слёзы - Noun
Environment - Среда - Noun
Surname - Фамилия - Noun
Employee - Сотрудник - Noun
Strength - Сильная сторона, сила - Noun
Beak - Клюв - Noun
Sun - Солнце - Noun
Spade - Лопата - Noun
Stamp - Марка - Noun
Candle - Свеча - Noun
Workflow - Рабочий процесс - Noun
Message - Сообщение - Noun
Apple - Яблоко - Noun
Judge - Судья - Noun
End - Конец, заканчивать - Noun
City - Город - Noun
Girl - Девочка - Noun
Simplicity - Простота - Noun
Kingdom - Королевство - Noun
Pipeline - Трубопровод - Noun
Collaborator - Соавтор - Noun
Lonelines - Одиночество - Noun
Assignee - Правопреемник - Noun
Present - Подарок - Noun
Sword - Меч - Noun
Speech - Речь - Noun
Stem - Корень - Noun
Categorize - Классификация - Noun
Peer - Сверстник - Noun
Road - Дорога - Noun
Brother - Брат - Noun
Consequence - Последствие - Noun
Reviewer - Рецензент - Noun
Labels - Метки - Noun
Cookie - Печиво - Noun
Act - Действие - Noun
Pencil - Карандаш - Noun
Spades - Пики (карты) - Noun
Flow - Поток - Noun
Concentration - Концентрация - Noun
Mystery - Тайна - Noun
Source - Источник - Noun
Submission - Представление - Noun
Career - Карьера - Noun
Accusetion - Обвинение - Noun
Bike - Мотоцикл - Noun
Feature - Особенность - Noun
Beans - Фасоль - Noun
Income - Доход - Noun
Irritation - Раздражение - Noun
Stranger - Незнакомец - Noun
Economy - Экономика - Noun
Thumb - Большой палец - Noun
Belt - Ремень - Noun
Tool - Инструмент - Noun
Regular verbs - Обычные глаголы - Noun
Crash - Сильный удар при падении - Noun
Jar - Банка - Noun
Constraint - Ограничение - Noun
Adjective - Прилагательное - Noun
Twilight - Сумерки - Noun
Society - Общество - Noun
Clarity - Ясность - Noun
Complaint - Жалоба - Noun
Gain - Прирост - Noun
Elections - Выборы - Noun
Hero - Герой - Noun
Pit - Яма - Noun
Letter - Буква - Noun
Pet - Питомец - Noun
Law - Закон - Noun
Individual - Личность - Noun
Impatience - Нетерпение - Noun
Kindness - Доброта - Noun
Constant - Постоянный, постоянная величина - Noun
Robbery - Ограбление - Noun
Country house - Загородный дом - Noun
Absence - Отсутствие, недостаток, неявка - Noun
Department - Отдел - Noun
Unit - Единица измерения, подразделение - Noun
Issue - Проблема - Noun
Battle - Битва - Noun
A lot - Много - Noun
Machine - Машина - Noun
Century - Век - Noun
Wood - Дерево, древесина, лес - Noun
View - Вид - Noun
Governor - Губернатор - Noun
Debugging - Отладка - Noun
Classmate - Одноклассник - Noun
Guild - Вина - Noun
Frugality - Бережливость - Noun
Inside - внутренняя часть, сторона - Noun
Living room - Прихожая комната - Noun
Leaves - Листья - Noun
Benefit - Выгода, польза - Noun
Clubs - Крест (карты) - Noun
Feedback - Обратная связь - Noun
Irregular verbs - Неправильные глаголы - Noun
Starting point - Отправная точка - Noun
Ocean - Океан - Noun
Device - Прибор - Noun
Property - земельная собственность, дом - Noun
Guy - Парень, чувак - Noun
News - Новости - Noun
Name - Имя, назвать - Noun
Advertisement - Рекламное объявление - Noun
Relationships - Отношения (с родителями) - Noun
Hearts - Черви (карты) - Noun
Foundation - Фундамент, основа - Noun
Memories - Воспоминания - Noun
Example - Пример - Noun
Connection - Связь - Noun
Wizard - Волшебник - Noun
Tweaking - Настройка - Noun
Dozen - дюжина - Noun
Bus station - Автовокзал - Noun
Inexactitude - Неточность - Noun
Payroll - Начисление заработной платы - Noun
Notion - Понятие - Noun
Longitude - Долгота - Noun
Facilities - Удобства - Noun
Revenue - Доход - Noun
Expectation - Ожидание - Noun
Latitude - Широта - Noun
Striving - Стремление - Noun
Exiting - Выход - Noun
Humility - Смирение - Noun
Core - суть, сущность - Noun
Conversion - Преобразование - Noun
Sink - Раковина - Noun
Future - Будущее - Noun
Background - Фон - Noun
Minority - Меньшинство - Noun
Luxury - Роскошь - Noun
Identifier - Идентификатор - Noun
Startup - Запуск - Noun
Guidelines - Рекомендаций - Noun
Weed - Трава - Noun
Shutdown - Завершение работы - Noun
Layout - Макет - Noun
Configuration - Настройка - Noun
Weirdo - Чудак - Noun
Fridge - Холодильник - Noun
Vendor - Продавец - Noun
Equality - Равенство - Noun
Bucket - Ведро - Noun
Underscore - Нижнее подчеркивание - Noun
Story - История - Noun
Maintainability - Ремонтопригодность - Noun
History - История - Noun
Escape - Побег - Noun
Preface - Предисловие - Noun
Recycling - Переработка - Noun
Forecast - Прогноз - Noun
Paramount - Первостепенное значение - Noun
Vocabulary - Словарный запас - Noun
Invocation - Призыв - Noun
Decoupling - Развязка - Noun
Cheek - Щека - Noun
Robber - Грабитель - Noun
The needy - Нуждающиеся - Noun
Sentinel - Дозорный - Noun
Leak - Утечка - Noun
Wrapping Up - Подведение итогов - Noun
Inventory - Инвентарь - Noun
Host - Хозяин - Noun
Pattern - Шаблон - Noun
Ski - Лыжи - Noun
Wire - Проволока - Noun
Delays - Задержки - Noun
Credentials - Реквизиты для входа - Noun
Storing - Хранение - Noun
Instances - Экземпляры - Noun
Malicious code - Вредоносный код - Noun
Separation - Разделение - Noun
Handler - Обработчик - Noun
Closures - Замыкания - Noun
Moustache - Усы - Noun
Backpressure - Обратное давление - Noun
Gap - Пробел - Noun
Carrot - Морковь - Noun
Starvation - Голод - Noun
Layer - Слой - Noun
Stomach - Живот - Noun
Beard - Борода - Noun
Bundle - Пучок - Noun
Pause - Пауза - Noun
Convention - Соглашение - Noun
Entities - Сущности - Noun
Baton - Дубинка - Noun
Boot - Башмак - Noun
Stuff - Вещи - Noun
Junk - Хлам - Noun
Bookkeeping - Бухгалтерия - Noun
Inwards - Внутренности - Noun
Scoreboard - Табло - Noun
Embrace - Объятие - Noun
Enterprise - Предприятие - Noun
Losses - Убытки - Noun
Novice - Новичок - Noun
Adoption - Принятие - Noun
Target - Цель - Noun
Boundary - Граница - Noun
Janitor - Уборщик - Noun
Talent - Талант - Noun
Lung - Легкое - Noun
Essay - Сочинение - Noun
Christmas tree - Рождественская елка - Noun
Wires - Провода - Noun
Frameworks - Рамки - Noun
Serves - Услуга - Noun
Schema - Схема - Noun
Nod - Кивок - Noun
Poster - Плакат - Noun
Mess - Беспорядок - Noun
Fence - Забор - Noun
Flavor - Вкус - Noun
Haircut - Стрижка - Noun
Fare - Плата за проезд - Noun
Recipe - Рецепт - Noun
Purse - Кошелек - Noun
Stairs - Лестница - Noun
Turning point - Поворотный момент - Noun
Cans - Банки - Noun
Mansion - Особняк - Noun
Pineapple - Ананас - Noun
Tuna - Тунец - Noun
Announcement - Объявление - Noun
Flood - Наводнение - Noun
Cheers - Здоровье - Noun
Bone - Кость - Noun
Injustice - Несправедливость - Noun
Desert - Пустыня - Noun
Justice - Справедливость - Noun
Beverage - Напиток - Noun
Luggage - Багаж - Noun
Dishes - Посуда - Noun
Dish - Блюдо - Noun
Utensils - Приборы (вилки, ложки) - Noun
Dining hall - Столовая - Noun
Throat - Горло - Noun
Lightning - Молния - Noun
Elbow - Локоть - Noun
Stove - Плита - Noun
Agenda - Порядок дня - Noun
Headache - Головная боль - Noun
Thunder - Гром - Noun
Groceries - Продукты - Noun
Tissue - Салфетка - Noun
Messy - Беспорядочный - Noun
Mop - Швабра - Noun
Pill - Таблетка - Noun
Shame - Стыд - Noun
Drawer - Выдвижной ящик - Noun
Priest - Священник - Noun
Graduation - Выпускной - Noun
Dorm - Общежитие - Noun
Honey - Мёд - Noun
Couch - Диван - Noun
Outfit - Наряд - Noun
Row - Ряд - Noun
Rug - Коврик - Noun
Pot - Кастрюля - Noun
Dishwasher - Посудомоечная машина - Noun
Fever - Высокая температура - Noun
Sunset - Закат - Noun
Heater - Обогреватель - Noun
Carpet - Ковер - Noun
Curtains - Занавески - Noun
Crowd - Толпа - Noun
Mug - Кружка - Noun
Roommate - Сосед по комнате - Noun
Beverages - Напитки - Noun
Blanket - Одеяло - Noun
Killed - Убит - Past
Were they under arrest - Они были под арестом? - Past
Were you in trouble - Ты был в беде? - Past
I heard it on tv - Я услышал это по телевизору - Past
Went on - Продолжил - Past
Deserved - Заслужила - Past
I hear it for the first time - Я слышу это первый раз - Phrase
Establish the order - Установить порядок - Phrase
Precise details - Точные подробности - Phrase
Go anywhere you want to - Иди куда угодно - Phrase
May the force be with you - Пусть будет с тобой сила - Phrase
Will Continue doing - Будет продолжать делать - Phrase
What kind of - Какого рода? - Phrase
At the moment - В данный момент - Phrase
Went to the park on foot - Пошли в парк пешком (go) - Phrase
The teacher had given me the answer - Учитель дал мне ответ - Phrase
So what - Ну и что? - Phrase
Nasty weather - Неприятная погода - Phrase
Human beings - существа человеческие - Phrase
Affirmative sentence - Утвердительное предложение - Phrase
Accept failure - Принимать неудачу - Phrase
Take into account - Взять во внимание - Phrase
Go for a walk - Идти гулять пешком - Phrase
Speak up - Говорить громче - Phrase
Send a text message - Отправлять текстовое сообщение - Phrase
Worse and worse - Все хуже и хуже - Phrase
How often - Как часто - Phrase
What is the girl laughing at - Над чем смеется девушка - Phrase
Subtract 2 from 10 - Вычесть 2 из 10 - Phrase
What are you listening to - Что ты слушаешь? - Phrase
Another country - Другая страна - Phrase
Surf the internet - Серфить в интернете - Phrase
She had not earned anything - Она ничего не заработала - Phrase
I busy next week - Я занят на следующей неделе - Phrase
Mark as draft - Отметить как черновик - Phrase
Tax rate - Ставка налога - Phrase
Just in case - На всякий случай - Phrase
Last Resort - Крайнее средство - Phrase
What are you thinking about - О чем ты думаешь? - Phrase
The most interesting - Самый интересный - Phrase
Put on clothes - Надевать одежду - Phrase
Run away - Убегай - Phrase
Go to work - Идти на работу - Phrase
What are you talking to - О чем ты говоришь? - Phrase
The set of programs - Набор программ - Phrase
All ears - Во все уши - Phrase
Present perfect - Настоящее совершенное - Phrase
Waste of time - Потеря времени - Phrase
A couple of questions - Пара вопросов - Phrase
Nested loop - Вложенный цикл - Phrase
You don't say - Не может быть - Phrase
I have read the newspaper - Я прочитал эту газету - Phrase
Take a shower - Принимать душ - Phrase
Make dream come true - Осуществить мечту - Phrase
He is away - Он отсутствует (уехал далеко) - Phrase
I wonder if you could help me - Интересно, сможешь ли ты мне помочь - Phrase
Hard working - Трудолюбивый - Phrase
Only once - Только раз - Phrase
As far as i know - Насколько я знаю - Phrase
What are you loking for - Что ты ищешь? - Phrase
Follow your dreams - Следовать своим мечтам - Phrase
Stay curious - Оставайтесь любопытными - Phrase
Case sensitive - С учетом регистра - Phrase
Wash - Стирать - Phrase
Catch up - Догонять - Phrase
Make a plan - Составить план - Phrase
Work towards your goal - Работать на достижение цели - Phrase
My native city - Мой родной город - Phrase
Take a break - Сделать перерыв - Phrase
Suggested going - Предлагал пойти (past) - Phrase
I'm ready for the consequences - Я готов к последствиям - Phrase
Work hard - Усердно работать - Phrase
Entirely independent - Полностью независимыми - Phrase
Celebrate success - Праздновать успех - Phrase
I mind doing it - Я возражаю делать это - Phrase
Write it down - Записывать что то - Phrase
Let's figure out - Давайте разберемся - Phrase
This problem has nothing to do with you - Эта проблема не имеет к тебе отношения - Phrase
Close connection - Тесная связь - Phrase
Another opportunity - Еще одна возможность - Phrase
First sight - Первый взгляд - Phrase
Continue doing - Продолжить делать - Phrase
Implement from scratch - Реализовать с нуля - Phrase
I'm currently working on the current project - Сейчас я работаю над текущим проектом - Phrase
Sit down - Присесть - Phrase
in any case - в любом случае - Phrase
Better and better - Лучше и лучше - Phrase
Love at first sight - Любовь с первого взгляда - Phrase
More and more popular - Все популярнее - Phrase
Not necessarily - Не обязательно - Phrase
Latest news - Последние новости - Phrase
I'm still making mistakes but small ones - Я все еще делаю ошибки, но маленькие - Phrase
He is out of control - Он вышел из под контроля - Phrase
Piss me off - Вывести из себя - Phrase
More than enough - Больше чем достаточно - Phrase
Limited precision - Ограниченная точность - Phrase
I will go to sleep - Я пойду спать - Phrase
I'm working on the current project - Я работаю над текущим проектом - Phrase
Higher and higher - Все выше и выше - Phrase
At this point - В данный момент - Phrase
Get undressed - Раздеваться - Phrase
Both sides - Обе стороны - Phrase
One more time - Еще раз - Phrase
Throughout this book - На протяжении всей этой книги - Phrase
Whatever is returned - Что бы ни было возвращено - Phrase
State Verbs - Глаголы состояния - Phrase
Do harm to the environment - Наносить вред окружающей среде - Phrase
Enclosing scope - Охватывающая область - Phrase
Feel free to contact me - Обращайтесь в любое время - Phrase
Climb up the tree - Лезть на дерево - Phrase
Claim to faim - Притязание на славу - Phrase
To what extent - В какой степени - Phrase
Glancesability - Обзорность - Phrase
Our knowledge is getting bigger and bigger - Наши знания становятся больше и больше - Phrase
Watch your mouth - Следи за словами - Phrase
Clean the house - Убирать дом - Phrase
Last for - Длится _ - Phrase
Undressed - Раздетый - Phrase
Give up smoking - Бросить курить - Phrase
Is there a way to prevent it - Есть ли способ предотвратить это? - Phrase
Admit your mistakes - Признавать свои ошибки - Phrase
He assumes - Он предпологает - Phrase
The internet has given me many possibilities - Интернет дал мне много возможностей - Phrase
Non of us - Никто из нас - Phrase
I lay down - Я лёг - Phrase
What are you talking about - О чем ты говоришь? - Phrase
It stopped working properly - Это перестало работать должным образом - Phrase
Find out - Выяснить - Phrase
I like more - Мне нравится больше - Phrase
Move on - Двигаться дальше - Phrase
My best - Всё возможное - Phrase
Walk into - Зайти внутрь - Phrase
Is queued up - Стоит в очереди - Phrase
German is hard - Німецька складна - Phrase
I feel sorry for the boy - Мне жаль этого парня - Phrase
At once - Сразу же (во первых) - Phrase
Take place - Проходит (иметь место) - Phrase
Tips and tricks - Уловки и трюки - Phrase
To be frank - Быть честным - Phrase
After some time - Через некоторое время - Phrase
Fall in love - Влюбляться - Phrase
To be honest - Быть честным - Phrase
I started to cover this subject - Я начал освещать эту тему - Phrase
In terms of - С точки зрения - Phrase
Learn from your mistakes - Учиться на своих ошибках - Phrase
Pretty tired - Достаточно уставший - Phrase
According to plan - Согласно плану - Phrase
I'll do My best - Я сделаю всё возможное - Phrase
Identify how handles - Определите, как справляется - Phrase
See the difference - Увидеть разницу - Phrase
Last for about - (это будет) длится около - Phrase
Sell for - Продать за - Phrase
Some time later - Некоторое время спустя - Phrase
That is worth it - Это стоит того - Phrase
Curly brace - Изогнутая скоба - Phrase
Very common shortening - Очень распространенное сокращение - Phrase
Given a time - Учитывая время - Phrase
Ask for help - Попросить помощи - Phrase
Low blow - Удар ниже пояса - Phrase
We are getting off - Мы выходим - Phrase
Go home - Идти домой - Phrase
Stay positive - Оставаться позитивным - Phrase
Learning Objectives - Цели обучения - Phrase
She washed herself - Она покупалась - Phrase
Against the law - Противозаконно - Phrase
Embrace change - Принимать перемену - Phrase
Face your fears - Преодолеть свои страхи - Phrase
Little time - Мало времени - Phrase
Cherish your loved ones - Дорожить близкими - Phrase
Do the laundry - Идти в прачечную - Phrase
Rule of thumb - Практическое правило (правило большого пальца) - Phrase
Forgive and forget - Прощать и забывать - Phrase
Strict rules - Строгие правила - Phrase
Time instant - Момент времени - Phrase
Few friends - Мало друзей - Phrase
Spelling mistake - Грамматическая ошибка - Phrase
Stay humble - Оставаться скромным - Phrase
Get well soon - Поправляйся бистрее - Phrase
A Bit - Немного B - Phrase
Learn something new - Узнать что - Phrase
Add submission - Добавить представление - Phrase
Had a rest - Отдыхал - Phrase
Live in the moment - Жить в настоящем моменте - Phrase
Completion requirements - Требования к завершению - Phrase
Go Shopping - Ходить за покупками - Phrase
The only right - Единственно верное - Phrase
Do The Shopping - Делать покупки - Phrase
He is good at English - Он хорош в английском - Phrase
A well paid job - Хорошо оплачиваемая работа - Phrase
Scientific research - Научное исследование - Phrase
Stand up - Встать - Phrase
All my best - Всё возможное - Phrase
Who gave this order and why - Кто отдал этот приказ и почему - Phrase
Elapsed time - Прошедшее время - Phrase
I mean - Я имею в виду - Phrase
Simply drop - Просто брось - Phrase
Are you going to prevent the crisis - Вы собираетесь предотвратить кризис - Phrase
It seems to be - Это кажется - Phrase
What he had written was true - Что он написал было правдой - Phrase
What made him change his mind - Что заставило его изменить свое мнение - Phrase
To what degree - В какой степени - Phrase
My memory lets me down - Моя память подводит меня - Phrase
The edge of the building - Край здания - Phrase
From which direction - С какого направления - Phrase
He drowned - Он утонул - Phrase
I really didn't like it - Мне реально не нравилось это - Phrase
To get in touch with - Связаться с - Phrase
Present continuous - Настоящее длительное - Phrase
Present progressive - Настоящее длительное - Phrase
Give a speech - Выступить с промова - Phrase
Have a good time - Хорошо провести время - Phrase
None of them - Никто из них - Phrase
It rained for a week - Дождь шел в течение недели - Phrase
Waste time - Тратить время - Phrase
I thought you had found the suitcase - Я думал, что вы нашли чемодан - Phrase
I was wondering if you could do it - Мне было интересно, сможешь ли ты это сделать - Phrase
It goes without saying - Это само собой разумеется - Phrase
On my own - Самостоятельно - Phrase
Take a nap - Вздремнуть - Phrase
Go away - Уйди - Phrase
Rarely enough - Достаточно редко - Phrase
Wash up the dishes - Мыть посуду - Phrase
To our surprise - К нашему удивлению - Phrase
He Teach me a lesson - Он преподал мне урок - Phrase
Past continuous - Прошедшее продолжительное - Phrase
Pass by - Проходят мимо - Phrase
Holy crap - Чёрт возьми - Phrase
This is a total failure - Это полный провал - Phrase
Change of clothes - Сменная одежда - Phrase
Negative form - Форма отрицания - Phrase
Park there - Парковаться там - Phrase
Always the same - Всегда одно и тоже - Phrase
Listen to music - Слушать музыку - Phrase
Don't freak out - Не паникуй - Phrase
Climb down the tree - Слазить с дерева - Phrase
Turn on - Включить - Phrase
Everything possible - Всё возможное - Phrase
He is out - Его нет дома (но он рядом) - Phrase
Order food - Заказывать еду - Phrase
In total - Всего (нас всего) - Phrase
I mean to do it - Я хочу сделать это - Phrase
Had a good time together - Провели хорошо время вместе - Phrase
My mother had felt nothing - Моя мама не почувствовала ничего - Phrase
Keep going - Продолжать двигаться вперед (хранить идти) - Phrase
It's very kind of you - Это очень приятно с твоей стороны - Phrase
There was a great lack of rice that year - В том году было большое нехватка риса - Phrase
Resolve the conflict - Решить конфликт - Phrase
Under the hood - Под капотом - Phrase
Over time everything changes - Со временем всё меняется - Phrase
Moving forward - Двигаясь дальше - Phrase
Take part - Принимать участие - Phrase
Owe them - Должен им - Phrase
I cut myself - Я порезался - Phrase
I heard it in the news - Я услышал это в новостях - Phrase
Go hand in hand - Идти плечо к плечу - Phrase
What is going on - Что происходит - Phrase
A round of fruit - Круглый фрукт - Phrase
Behave very badly - Вести себя очень плохо - Phrase
It hasn't rained this summer - Этим летом не было дождя (ещё) - Phrase
Meet friends - Встречаться с друзьями - Phrase
She is in debt to me - Она в долгу перед до мной - Phrase
How long time ago was it - Как давно это было - Phrase
Trust your instincts - Доверять своим инстинктам - Phrase
He listened to both sides - Он выслушал обе стороны - Phrase
Take into consideration - Взять во внимание - Phrase
I have nothing to do with this matter - Я не имею отношения к этому делу - Phrase
Bad news travels fast - Плохие новости распространяются быстро - Phrase
Try new things - Пробовать новые вещи - Phrase
Another apple - Еще одно яблоко - Phrase
Start doing - Начинать делать - Phrase
Strictly adhered - Строго соблюдается - Phrase
She went on speaking - Она продолжила говорить - Phrase
Have a rest - Отдыхать - Phrase
He washed himself - Он покупался - Phrase
Set a goal - Поставить цель - Phrase
I washed myself - Я покупался - Phrase
One point - Одно очко - Phrase
He laughs who laughs last - Смеётся тот кто смеётся последний - Phrase
Hurry up - Торопиться - Phrase
A neat way - Отличный способ - Phrase
Point of view - Точка зрения - Phrase
So far i have not received it - Пока что я не получил этого - Phrase
It was love at first sight - Это была любовь с первого взгляда - Phrase
How do they prepare this fish in France - Как готовят эту рыбу во Франции? - Phrase
Pay attention - Обращать внимание - Phrase
Other countries - Другие страны - Phrase
Keep an open mind - Оставаться открытым к новому - Phrase
Assume things about people - Предвзято относиться - Phrase
Walk by - Идти мимо - Phrase
Take responsibility - Возьмите ответственность - Phrase
Has turned into - Превратился в - Phrase
Keep in touch - Оставаться на связи - Phrase
Where do we begin - С чего мы начнём - Phrase
Second half - Вторая половина - Phrase
In the fall - Осенью - Phrase
Practice makes perfect - Практика делает совершенным - Phrase
See you tomorrow - Увидимся завтра - Phrase
i want to do it - Я хочу сделать это - Phrase
I had not eaten since Tuesday - Я не ел со вторника - Phrase
Get some rest - Отдохни(-> немного отдыха) - Phrase
Give back - Отдавать - Phrase
Other side - Другая сторона - Phrase
More or less - Более менее - Phrase
No Biggie - Не страшно - Phrase
Do the dishes - Мыть посуду - Phrase
On the right way - На правильном пути - Phrase
How do i add images to my page - Как мне добавить изображения на мою страницу - Phrase
Go to bed - Ложиться спать - Phrase
Take a bath - Принимать ванну - Phrase
As much as possible - Как можно больше - Phrase
Score a goal - Забивать гол - Phrase
Idle time - Время простоя - Phrase
Take your time - Не торопись (Взять твоё время) - Phrase
Believe in yourself - Верить в себя - Phrase
He wants to answer her - Он хочет ответить ей - Phrase
Keep it simple - Держи это простым(храни это просто) - Phrase
At least - Во всяком случае - Phrase
Each person - Каждый человек - Phrase
Each other - Друг друга - Phrase
Brush teeth - Чистить зубы (щётка зубы) - Phrase
To either gather - Либо собрать - Phrase
I have never had a car - У меня никогда не было машины - Phrase
In any case I like it here - Во всяком случае мне нравится тут - Phrase
Keep practicing - Продолжать тренироваться - Phrase
One chapter has turned into a book - Один раздел превратился в книгу - Phrase
Taught me a lesson - Преподал мне урок - Phrase
Each person has their own reality - Каждый человек имеет свою собственную реальность - Phrase
Stay organized - Будьте организованы - Phrase
Shake hands - Пожимать руки - Phrase
Calm down - Успокоиться - Phrase
Face problem - Столкнутся с проблемой - Phrase
I am going to ask them - Я позже спрошу их - Phrase
He Gets - Он получает - Phrase
I leave for - Я уезжаю в - Phrase
Cli tooling - Инструменты командной строки - Phrase
Take off clothes - Снимать одежду - Phrase
Know nothing - Не знать ничего - Phrase
I had my car repaired - Мне отремонтировали машину - Phrase
Pay slip - расчетный лист - Phrase
Be patient - Быть терпеливым - Phrase
Just in time - Как раз вовремя - Phrase
Close to his heart - Близко к его сердцу - Phrase
Stay true to yourself - Оставаться верным тебе - Phrase
I would have considered it - Я бы взял это во внимание - Phrase
Be grateful - Быть благодарным - Phrase
Achieve this aim - Достигнуть этой цели - Phrase
Only once in a year - Только раз в году - Phrase
It's a matter of time - Это дело времени - Phrase
For example - Например - Phrase
On time - Вовремя - Phrase
I need to weigh all the pros and cons - Мне нужно взвесить все за и против - Phrase
Perfectly realize - Прекрасно осознавать - Phrase
Help others - Помогать другим - Phrase
Explore the world - Исследовать мир - Phrase
Eat for breakfast - Есть на завтрак - Phrase
Do you mind - Вы возражаете - Phrase
Go out - Идти на выход, выходить - Phrase
If i were you - На твоём месте - Phrase
Response time - Время отклика - Phrase
Call back - Перезвонить - Phrase
Any longer - Не дольше - Phrase
I had not assumed anything - Я ничего не предполагал - Phrase
Sleep on it - Обдумать еще раз (Спать на нем) - Phrase
In general - В целом, в основном - Phrase
She doesn't affect me - Она не влияет на меня - Phrase
The side of the road - Узбіччя дороги - Phrase
I like better - Мне нравится больше - Phrase
Much more - Гораздо более - Phrase
For no reason - Без причины - Phrase
Smaller chunks - Меньшие фрагменты - Phrase
Cook dinner - Готовить ужин - Phrase
Curse luck - Ругать удачу (судьбу) - Phrase
Lose patience - Терять терпение - Phrase
West Coast - Западный берег - Phrase
Get close - Приблизиться - Phrase
With whom - С кем - Phrase
Zip it - Закрой рот - Phrase
Get dressed - Одеваться - Phrase
Watch TV - Смотреть телевизор - Phrase
Check email - Проверить электронную почту - Phrase
Good shape - Хорошая форма (спорт) - Phrase
Someone had opened the window - Кто то открыл окно - Phrase
The relevant fields - Соответствующие поля - Phrase
Take a chance - Рискнуть - Phrase
Is Based on - Основано на - Phrase
Whole night - Всю ночь - Phrase
Every human - Каждый человек - Phrase
Be yourself - Будь собой - Phrase
I have just come - Я только что пришел - Phrase
It happened by accident - Это произошло случайно - Phrase
Will Get tired - Скоро устанешь - Phrase
Full of joy - Полный радости - Phrase
Give it a try - Попробуйте (дай это попробовать) - Phrase
Finish it - Закончить это - Phrase
On top - Сверху - Phrase
Think it over - Обдумать это - Phrase
Probable outcome - Вероятный результат - Phrase
Make a deal - Заключить сделку - Phrase
Have fun - Веселиться, развлекаться - Phrase
There was no damage - Не было повреждения - Phrase
On a business trip - В командировке - Phrase
Have a good flight - Желаю хорошего полёта - Phrase
By heart - Наизусть - Phrase
I'm not in shape - Я не в форме - Phrase
How do we spell that - Как это написать - Phrase
All the best - Всего наилучшего - Phrase
Work properly - Работать правильно - Phrase
Is Anybody with you - С тобой кто то есть? - Phrase
Meditate - Медитировать - Phrase
Never lose hope - Никогда не терять надежду - Phrase
I washed my face - Я вымыл лицо - Phrase
The day before yesterday - Позавчера - Phrase
Flee - Спасаться бегством - Phrase
Get started - Начинай - Phrase
Read a book - Читать книгу - Phrase
What are you loking at - На что ты смотришь? - Phrase
Sense of humor - Чувство юмора - Phrase
The whole truth - Целая правда - Phrase
Set up a company - Основать компанию - Phrase
Stay focused - Оставаться сосредоточенным - Phrase
Who are you waiting for - Кого ты ждешь? - Phrase
Throw away - Выбросить - Phrase Verb
Point out - Заметить - Phrase Verb
Feel like - Хочу - Phrase Verb
Carry out - Проводить - Phrase Verb
Pass me - Передай мне - Phrase Verb
Slip in - Проскользнуть внутрь - Phrase Verb
Hang out - Проводить время - Phrase Verb
Fall back to - Вернуться к - Phrase Verb
Put on - Надевать (шапку) - Phrase Verb
Take on - Взять на - Phrase Verb
Rub out - Стереть - Phrase Verb
Lookup - Искать - Phrase Verb
Come across - Натолкнуться - Phrase Verb
Clear up - Очищать - Phrase Verb
Go on - Продолжать - Phrase Verb
Pick up - Подобрать - Phrase Verb
Tear Down - Снос - Phrase Verb
Save up - Копить - Phrase Verb
Take after - Похож - Phrase Verb
It matter - Это имеет значение (это важно) - Phrase Verb
Setting Up - Настройка - Phrase Verb
Cope with - Справляться с - Phrase Verb
Occurs - Имеет место - Phrase Verb
Get well - Выздороветь - Phrase Verb
Take risks - Рисковать - Phrase Verb
Call of - Отменить - Phrase verb
Give up - Бросать (курить) - Phrase verb
Getting old - Стареть - Phrase verb
Take care - Заботится - Phrase verb
Try out - Проверять - Phrase verb
Figure out - Понимать - Phrase verb
Come back - Вернуться (два слова) - Phrase verb
Put off - Откладывать (на потом) - Phrase verb
Address the problem - Решить проблему - Phrase verb
Bring up - Воспитывать - Phrase verb
You can store - Вы можете хранить - Phrase verb
Break down - Сломаться - Phrase verb
Corner - Перекресток - Place
Tent - Палатка - Place
Puddle - Лужа - Place
Local - Местный - Place
Church - Церковь - Place
Not - Не - Preposition
For instance - Например (сыр) - Preposition
The Costs - Издержки, расходы - Preposition
Yes - Да - Preposition
Despite - Не смотря на (одно слово) - Preposition
Responsibly - Ответственно - Preposition
Upon - На - Preposition
Front of - Перед (чем то) - Preposition
Reason for - Причина __ - Preposition
Happened to - Произошло с - Preposition
Prepare for - Готовится к - Preposition
It's just a mouse - Это просто мышь - Preposition
React to - Реагировать на - Preposition
Throw at me - Бросил в меня - Preposition
Ready for - Готов к - Preposition
Because of - Из-за - Preposition
Congratulate on - Поздравить с - Preposition
In - В - Preposition
Afraid of - Испуган от - Preposition
Since - Поскольку, с - Preposition
Rely on - Полагаться на - Preposition
Bring in - Приносить - Preposition
Suffer from - Страдать от - Preposition
Happen to - Случается с - Preposition
Off - Из, вне, Выключенный - Preposition
Interested in - Заинтересован в - Preposition
Bye - Пока - Preposition
Pay for - Платить за - Preposition
Translate from into - Переводить с на - Preposition
Attitude to - Отношение к - Preposition
Influence - Влиять на - Preposition
To succeed in - Преуспеть в - Preposition
And - И - Preposition
Refuse to - Отказываться от - Preposition
Succeed in - Преуспеть в - Preposition
Point at - Указать на - Preposition
If - Если - Preposition
Satisfied with - Удовлетворён с - Preposition
Wait for him - Ждать его - Preposition
In front of him - Спереди от него - Preposition
Belong to - Принадлежать - Preposition
Invite to - Приглашать на - Preposition
But - Но - Preposition
Impress by - Впечатлен от - Preposition
On Wednesdays - По средам - Preposition
By profession - По профессии - Preposition
Over - Над - Preposition
Bored with - Наскучило - Preposition
Laugh at - Смеяться над - Preposition
Rose by - Выросла на (цена) - Preposition
Switch on - Включить - Preposition
Approve of - Одобрять - Preposition
Or - Или - Preposition
Bad at - Плохо от - Preposition
Hi - Привет - Preposition
On Tuesday - Во вторник - Preposition
With - С - Preposition
Insist on - Настаивать на - Preposition
On - На - Preposition
Than - затем, Чем, кроме, как - Preposition
Sorry - Извини - Preposition
Through - Сквозь, через - Preposition
As always - Как всегда, як завжди - Preposition
Of - Из - Preposition
Wait for - Ждать _ (кого то) - Preposition
To - В, к - Preposition
Accuse of - Обвинять в - Preposition
Considering - Учитывая - Preposition
Tired of - Устал от - Preposition
Throw to me - Бросил мне - Preposition
Next to - Рядом - Preposition
Look it up in a dictionary - Найти это в словаре - Preposition
Arrive in at - Прибывать - Preposition
So - Так - Preposition
Before - До, перед - Preposition
Excited about - Взволнованный - Preposition
Lead to - Приводит к - Preposition
Aware of - Осведомлён о - Preposition
Depend on - Зависит от - Preposition
Ahead of - Впереди - Preposition
In August - В августе - Preposition
Devote to - Уделять (время) для - Preposition
Into - В - Preposition
No - Нет - Preposition
Be proud of - Гордиться за - Preposition
Across - Сквозь, через - Preposition
Due to - ИзЗа - Preposition
Supply with - Поставлять - Preposition
On a regular basis - На регулярной основе (регулярно) - Preposition
Within - В пределах - Preposition
Until - До - Preposition
Depends on - Зависит от - Preposition
Goodbye - До свидания - Preposition
Count on - Рассчитывать на - Preposition
Smile at - Улыбается над - Preposition
The following - Следующие (вопросы) - Preposition
Surprised by - Удивлён от - Preposition
Marry - Жениться на - Preposition
Consist of - Состоять из - Preposition
Near - Около, рядом - Preposition
Fond of - Обожаю - Preposition
Instead of - Вместо (него) - Preposition
Sail on - Плыть на чём то - Preposition
Ask for - Просит _ - Preposition
Adapt to - Адаптироваться к - Preposition
Inform of - Информировать о - Preposition
Listen to - Слышать кого то - Preposition
Proud of - Гордится за - Preposition
Till - До - Preposition
During - в течение - Preposition
Edge of - Край _ - Preposition
As - так же как, столько же как - Preposition
Get used to - Привыкать к - Preposition
Hello - Привет - Preposition
Keen on - Увлекатся - Preposition
Work for - Работать на - Preposition
Complain about - Пожаловаться на - Preposition
Independent of - Независимая от, самостоятельный _ - Preposition
In the beginning - В начале - Preposition
After - После - Preposition
Solution to - Решение __ - Preposition
In spite of - Несмотря на (с предлогом) - Preposition
Good at - Хорошо от - Preposition
Per - За (метр за секунду) - Preposition
Grateful to for - Благодарен __(кому за) - Preposition
Under - Под - Preposition
Subscribe to - Подписаться на - Preposition
Too - Слишком - Preposition
Except for - Кроме (огурцов) - Preposition
Get rid of - Избавлятся от - Preposition
Accustomed to - Привыкший к - Preposition
Angry with about - Рассержен на - Preposition
Without - Без - Preposition
Divide it into - Делить это на - Preposition
Spend on - Тратить на - Preposition
Fell off into - Упал с , на - Preposition
Code review - Кодовый обзор, проверка кода - Programming
Recursion - Рекурсия - Programming
Garbage collection - Сборка мусора - Programming
Interpreter - Интерпретатор - Programming
Foreach - Для каждого - Programming
Regression test - Регрессионное тестирование - Programming
Implementation - Выполнение - Programming
Whitespace - Пробелы - Programming
Version control - Контроль версий - Programming
Middleware - Промежуточное ПО - Programming
Parameter - Параметр - Programming
IDE - Интегрированная среда разработки - Programming
Queue - Очередь - Programming
Decryption - Расшифровка - Programming
Session - Сессия - Programming
Function - Функция - Programming
Algorithm - Алгоритм - Programming
Find - Находить - Programming
Module - Модуль - Programming
Constructor - Конструктор - Programming
Switch - Переключатель - Programming
Indentation - Отступы - Programming
Pass by value - Передача по значению - Programming
Snake_case - Стиль написания snake_case - Programming
Platform - Платформа - Programming
Integration test - Интеграционное тестирование - Programming
Authentication - Аутентификация - Programming
Object - Объект - Programming
Private - Приватный - Programming
Testing - Тестирование - Programming
Index - Индекс - Programming
Class - Класс - Programming
PascalCase - Стиль написания PascalCase - Programming
Update - Обновлять - Programming
Bug - Ошибка - Programming
Stack overflow - Переполнение стека - Programming
Git - Система контроля версий Git - Programming
Conditional - Условный - Programming
Pass by reference - Передача по ссылке - Programming
Abstract - Абстрактный - Programming
Set - Устанавливать - Programming
Call by value - Вызов по значению - Programming
Inheritance - Наследование - Programming
Profiler - Профилировщик - Programming
Heap - Куча - Programming
Yield - Возвращать последовательность - Programming
Encryption - Шифрование - Programming
Commit - Коммит - Programming
Comment - Комментарий - Programming
Encapsulation - Инкапсуляция - Programming
Early binding - Ранняя оценка - Programming
Compile - Компилировать - Programming
CamelCase - Стиль написания camelCase - Programming
Framework - Фреймворк - Programming
Allocate - Выделять память - Programming
Protected - Защищенный - Programming
Reverse - Обращать - Programming
Request - Запрос - Programming
Prepend - Добавлять в начало - Programming
Arithmetic - Арифметические операции - Programming
Compiler - Компилятор - Programming
Reference - Ссылка - Programming
Code style - Стиль кода - Programming
Polymorphism - Полиморфизм - Programming
Merge request - Запрос на слияние - Programming
Static - Статический - Programming
Conflict - Конфликт - Programming
Authorization - Авторизация - Programming
Increment - Увеличивать - Programming
Capacity - Емкость - Programming
Decrement - Уменьшать - Programming
Call by reference - Вызов по ссылке - Programming
Source branch - Исходная ветвь - Programming
Dictionary - Словарь - Programming
Merge - Слияние - Programming
Sort - Сортировать - Programming
Interface - Интерфейс - Programming
Deallocate - Освобождать память - Programming
Do - Делать - Programming
From - Из - Programming
Array - Массив - Programming
Debug - Отлаживать - Programming
Remove - Удалять - Programming
Descending - Убывающий - Programming
Group - Группировать - Programming
Target branch - Целевая ветвь - Programming
Web - Сеть, паутина - Programming
Memory leak - Утечка памяти - Programming
Value - Значение - Programming
Filter - Фильтровать - Programming
Iteration - Итерация - Programming
Where - Где - Programming
Virtual - Виртуальный - Programming
For - Для - Programming
External Dependencies - Внешние зависимости - Programming
Unit test - Модульное тестирование - Programming
Unpack - Распаковать - Programming
Assignment - Операция присваивания - Programming
Install - Установить - Programming
Bitwise - Побитовые операции - Programming
Comparison - Операции сравнения - Programming
Cache - Кэш - Programming
Stack - Стек - Programming
List - Список - Programming
Initialize - Инициализировать - Programming
Delete - Удалять - Programming
Replace - Заменять - Programming
Repository - Репозиторий - Programming
Logical - Логические (операции) - Programming
Throw - Выбрасывать исключение - Programming
Select - Выбирать - Programming
Inner - Внутренний - Programming
Shift - Сдвиг - Programming
Pointer - Указатель - Programming
Lambda - Лямбда - Programming
Public - Публичный - Programming
Maintainers Guide - Руководство сопровождающего - Programming
Branch - Ветка - Programming
Left - Левый - Programming
Error - Ошибка - Programming
Data structure - Структура данных - Programming
Case - Случай - Programming
Validate - Подтвердить - Programming
Variable - Переменная - Programming
Outer - Внешний - Programming
By - По - Programming
Documentation - Документация - Programming
Full - Полный - Programming
Aggregate - Агрегировать - Programming
Map - Отображать, карта - Programming
Default - По умолчанию - Programming
Pointer arithmetic - Арифметика указателей - Programming
Execute - Выполнять - Programming
Create - Создавать - Programming
Vendor folder - Папка поставщика - Programming
Right - Правый - Programming
Destructor - Деструктор - Programming
Loop - Цикл - Programming
Method - Метод - Programming
Return - Возвращаемое значение - Programming
Order - Упорядочить - Programming
Ascending - Возрастаю - Programmingщий
Itself - Само - Pronoun
Every - Каждый - Pronoun
Away - Прочь - Pronoun
Which - Который - Pronoun
Those - Те - Pronoun
Everyone - Все - Pronoun
That - Тот - Pronoun
Each - Каждый - Pronoun
Somebody - Кто нибудь - Pronoun
Such - Такой - Pronoun
Anything - Что угодно - Pronoun
Nobody - Никто - Pronoun
Who - Кто - Pronoun
This - Этот - Pronoun
Along - Вдоль - Pronoun
About - О - Pronoun
Here - Здесь - Pronoun
Behind - За (ним) - Pronoun
It - Это - Pronoun
Everything - Всё - Pronoun
Much - Много - Pronoun
Many - Много (идей) - Pronoun
Towards - В направлении - Pronoun
There - Там - Pronoun
Else - Ещё, иначе, кроме - Pronoun
Other - Другие - Pronoun
What - Что - Pronoun
Fewer - Меньше - Pronoun
When - Когда - Pronoun
Everybody - Все - Pronoun
How many - Сколько (друзей) - Pronoun
Oneself - Себя - Pronoun
Among - Среди - Pronoun
These - Эти - Pronoun
Sometimes - Иногда - Pronoun
They - Они - Pronoun
You - Ты - Pronoun
How - Как - Pronoun
Around - Вокруг - Pronoun
Anybody - Любой, никто, всякий (body) - Pronoun
Another - Другой (мир) - Pronoun
She - Она - Pronoun
Any - Любой - Pronoun
someone - Кто нибудь - Pronoun
He - Он - Pronoun
Few - Мало - Pronoun
At - В, на - Pronoun
Between - Между - Pronoun
Anyone - Любой - Pronoun
All - всё - Pronoun
Nearby - Рядом - Pronoun
Some - Некоторое количество - Pronoun
Why - Почему - Pronoun
Nothing - Ничего - Pronoun
Owe - Быть должным - State Verb
Deserve - Заслуживать - State Verb
Doubt - Сомневаться - State Verb
Concern - Касаться - State Verb
Belong - Принадлежать - State Verbs
Feel - Чувствовать, в значении эмоций - State Verbs
Love - Любить - State Verbs
Appear - Появляться - State Verbs
Seem - Казаться - State Verbs
Hear - Слышать - State Verbs
Consider - Считать, размышлять - State Verbs
Believe - Верить - State Verbs
Be - Быть: am, is, are, was, were, etc - State Verbs
Need - Нуждаться - State Verbs
Forget - Забывать - State Verbs
Mean - Иметь в виду - State Verbs
Hate - Ненавидеть - State Verbs
Think - Думать, в значении мнения - State Verbs
Realize - Понимать, осознавать - State Verbs
Taste - Чувствовать вкус - State Verbs
Like - Любить - State Verbs
Want - Хотеть - State Verbs
Recognize - Узнавать - State Verbs
Understand - Понимать - State Verbs
Prefer - Предпочитать - State Verbs
Remember - Помнить - State Verbs
Smell - Нюхать - State Verbs
See - Видеть, в значении понимания - State Verbs
Have - Иметь, в значении свойства - State Verbs
Know - Знать - State Verbs
Brilliant - Блестящий - Studies
Meaning - Значение - Studies
Conditions - Условия - Studies
Competition - Соревнование - Studies
Beginner - Новичок - Studies
Sentence - Речення - Studies
Expression - Выражение - Studies
Prepare - Подготовится - Studies
Wise - Мудрый - Studies
Multiplication - Умножение - Studies
Simple - Простой - Studies
In The end - В конце - Studies
Condition - Условия - Studies
Improve - Улучшить - Studies
Obviously - Очевидно - Studies
Pass - Сдать (тест) - Studies
Educated - Образованный - Studies
Rightly - Правильно (r) - Studies
Multiply - Умножить - Time
Day - День - Time
Sunday - Воскресенье - Time
What time - В какое время - Time
Tuesday - Вторник - Time
Generation - Поколение - Time
Winter - Зима - Time
The day after tomorrow - Послезавтра - Time
Evening - Вечер - Time
Saturday - Суббота - Time
As soon as possible - Как можно быстрее - Time
October - Октябрь - Time
March - Март - Time
Week - Неделя - Time
At the end of the meeting - В конце встречи - Time
For years - Годами - Time
Usually - Обычно - Time
Friday - Пятница - Time
January - Январь - Time
In a year - (выучить) за год - Time
Half an hour - Полчаса - Time
Slowly - Медленно S - Time
On Holiday - На выходных - Time
Early - Рано - Time
At first - Сначала - Time
Autumn - Осень - Time
Right now - Прямо сейчас - Time
Wednesday - Среда - Time
November - Ноябрь - Time
Thursday - Четверг - Time
February - Февраль - Time
Earlier - Ранее - Time
Sooner or later - Рано или поздно - Time
June - Июнь - Time
Decade - 10 летие - Time
December - Декабрь - Time
Year - Год - Time
Summer - Лето - Time
Time - Время - Time
Monday - Понедельник - Time
At the beginning of the year - В начале этого года - Time
Present day - Сегодня - Time
September - Сентябрь - Time
Night - Ночь - Time
Get up - Вставать - Time
August - Август - Time
Spring - Весна - Time
April - Апрель - Time
Month - Месяц - Time
Morning - Утро - Time
Hour - Час - Time
Fourth - Четвёртое - Time
Ticket - Билет - Travel
Abroad - За границей - Travel
Recover - Восстанавливать - Verb
Unraveling - Распутывание - Verb
Explore - Исследовать - Verb
Spill - Проливать - Verb
Fuck - Трахать - Verb
Shudder - Содрогаться - Verb
Pour - Налить - Verb
Fell - Упал - Verb
Make - Делать (что то новое) - Verb
Expand - Расширение - Verb
Foster - Воспитывать - Verb
State - Утверждать - Verb
Found - Основать - Verb
Expect - Ожидать - Verb
Underline - Подчеркивать - Verb
Frighten - Пугает - Verb
Lock - Запирать - Verb
Estimate - Оценивать - Verb
Explode - Взрываться - Verb
Cheat - Обманывать - Verb
Hug - Обнимать - Verb
Eliminate - Устранять - Verb
Unlock - Открывать - Verb
Climb - Лазить - Verb
Possess - Владеть - Verb
Check - Проверить - Verb
Exercise - Заниматься спортом - Verb
Stumble - Спотыкаться - Verb
Capitalize - писать прописными буквами - Verb
Eat - Кушать - Verb
Reuse - повторно использовать - Verb
Kill - Убийство - Verb
Shout - Кричать - Verb
Disambiguate - Устранять двусмысленность - Verb
Fly - Летать - Verb
Enjoy - Наслаждаться - Verb
Won - Выиграл - Verb
Attend - Посещать, заниматся - Verb
Enter - Входить, вступать, поступать - Verb
Translate - Переводить - Verb
Stand - Стоять - Verb
Keep - Держать (хранить) - Verb
Hold - Держать - Verb
Attach - Прикреплять - Verb
Forgive - Простить - Verb
Participate - Принимать участие - Verb
Analyse - Анализировать - Verb
Trust - Доверять - Verb
Inform - Информировать - Verb
Lend - Давать в долг - Verb
Share - Делится - Verb
Respect - Уважать - Verb
Sell - Продавать - Verb
Drink - Пить - Verb
Discard - Отказываться (D) - Verb
Collide - Сталкиваться - Verb
Provid - Обеспечивать - Verb
Become - Стать - Verb
Block - Блокировать - Verb
Staring - Пялится - Verb
Complete - Завершать - Verb
Demonstrate - Демонстрировать - Verb
Invest - Инвестировать - Verb
Wave - Махать - Verb
Read - Читать - Verb
Bake - Выпекать - Verb
Tapping - Постукивать - Verb
Charge - Заведует (чем то) - Verb
Cover - Покрывать, освещать - Verb
Include - включать (в себя) - Verb
Widen - Расширять - Verb
Skiing - Кататься на лыжах - Verb
Serve - Подавать - Verb
Blackmail - Шантажировать - Verb
Weigh - Весить - Verb
Supply - Поставлять - Verb
Wait - Ждать - Verb
Involve - Подразумевать - Verb
Reinvent - Переизобретать, создавать новую версию - Verb
Dispatch - Отправлять (D) - Verb
Precedes - Предшествует - Verb
Derive - Вывести - Verb
Develop - Развивать - Verb
Run out of - Закончились - Verb
Disturb - Мешать - Verb
Revise - Повторить - Verb
Hunt - Охотиться - Verb
Ensure - Обеспечивать - Verb
Digest - Переваривать - Verb
Donate - Жертвовать - Verb
Survive - Выживать - Verb
Compare - Сравнивать - Verb
Treat - Обращаться - Verb
Admire - Восхищаться - Verb
Express - Выражать - Verb
Require - Требовать - Verb
Discourage - Отговаривать - Verb
Drown - Тонуть (человек) - Verb
Drop - Уронить - Verb
Carry - Нести - Verb
Knock at - Стучать в - Verb
Scream - Вскрикнуть - Verb
Follow - Следуй (иди за мной) - Verb
Wound - Ранить - Verb
Persuade - Убеждать - Verb
Add - Добавлять - Verb
Store - Хранить - Verb
Ignore - Игнорировать - Verb
Deny - Отрицать - Verb
Praise - Хвалить - Verb
Whisper - Шептать - Verb
Notice - замечать - Verb
Scan - Сканировать - Verb
Transfer - Передавать - Verb
Rent - Арендовать - Verb
Borrow - Брать в долг - Verb
Elapse - Проходит - Verb
Excuse - извинять, прощать - Verb
Strip - Избавиться - Verb
Travel - Путешествовать - Verb
study - учить, изучать - Verb
Tolerate - Терпеть - Verb
Greet - Приветствовать - Verb
Drive - Управлять (ехать) - Verb
Pray - Молиться - Verb
Deliver - Доставлять - Verb
Raise - Растить - Verb
Force - Заставить - Verb
Get - Получать - Verb
Send - Отправить - Verb
Confess - Признаваться - Verb
Disappear - Исчезли  - Verb
Please - Пожалуйста - Verb
Announce - Объявить - Verb
Division - Деление - Verb
Watch - Смотреть (телевизор) - Verb
Celebrate - Праздновать - Verb
Relax - Расслабляться - Verb
Plan - Планировать - Verb
Ask - Спрашивать - Verb
Rest - Отдых - Verb
Dance - Танцевать - Verb
Remind - Напоминать - Verb
Mention - Упоминать - Verb
Increase - Усилить - Verb
Own - Владеть - Verb
Regulate - Регулировать - Verb
Explain - Объясни - Verb
Encourages - Поощряет - Verb
Suppose - Предполагать - Verb
Felt - Упал - Verb
Show - Показывать - Verb
Talk - Разговаривать - Verb
Ruin - Разрушать - Verb
Pull - Тянуть - Verb
Assert - Утверждать - Verb
Click - Щелкнуть - Verb
Betray - Предавать - Verb
Breakup - Расстаться - Verb
Pollute - Загрязнять - Verb
Twist - Крутить - Verb
Weaken - Ослаблять - Verb
Pretend - Притворяться - Verb
Swear - Клясться - Verb
Revis - Повторить, пересмотреть - Verb
Decorate - Украшать - Verb
Enlarge - Увеличивать - Verb
Devote - Уделять - Verb
Emphasize - Подчеркивать - Verb
Identify - Идентифицировать - Verb
Rob - Грабить - Verb
Using - ИспольЗУЯ - Verb
Threaten - Угрожать - Verb
Declare - Объявлять - Verb
Save - Спасать - Verb
Spawn - Порождать - Verb
Calculate - Рассчитать - Verb
Welcome - Встречать - Verb
Mix up - Перемешать - Verb
Tweak - Корректировать - Verb
Rub - Тереть - Verb
Erase - Стереть - Verb
Finish - Закончить - Verb
Speak - Говорить - Verb
Arrange - Договариваться - Verb
Learn - Учиться - Verb
Pick - выбирать - Verb
Afford - Позволить себе - Verb
Establish - Основывать, установить - Verb
Dry - Сушить - Verb
Expected - Ожидал (past) - Verb
Assign - Назначать - Verb
Surround - Окружать - Verb
Graduate from - Закончить (университет) - Verb
Return - возвращаться - Verb
Behave - Ведёт себя - Verb
Mismatch - не подходить друг другу - Verb
Inspire - Вдохновлять - Verb
Distinguish - Различать - Verb
Signify - Обозначать - Verb
Beware - Остерегаться - Verb
Fit - Подходить - Verb
Join - Присоединится - Verb
Take - Брать - Verb
Underscores - Подчеркивает - Verb
Manage - справляться, ухитряться - Verb
Describe - Описывать - Verb
Dereference - Разыменование - Verb
Suit - быть к лицу - Verb
Adjust - Регулировать - Verb
Evaluate - Оценивать - Verb
Define - Определять, давать характеристику - Verb
Control - Контролирую - Verb
Transform - Превратиться, трансформировать - Verb
Grabbe - Хватать - Verb
Enumerate - Перечислить - Verb
Breathe - Дышать - Verb
Accuse - Обвинять - Verb
Bounce - Подпрыгивать - Verb
Prefer - Предпочитать - Verb
Denote - Обозначать - Verb
Neglect - Пренебрегать - Verb
Invent - Изобретать - Verb
Breakdown - Расстаться - Verb
Contact - Связаться - Verb
Claim - Претендовать - Verb
Accomplish - Выполнить - Verb
Developed - Развивать (past) - Verb
Basically - В основе - Verb
Die - умирать - Verb
Reflect - Отражать - Verb
Encourage - Поощрять - Verb
Organize - Организовать - Verb
Kiss - Целовать - Verb
Stimulate - Стимулировать - Verb
Exchange - Поменять - Verb
Protect - Защищать - Verb
Satisfy - Удовлетворять - Verb
Impose - Навязывать - Verb
Turn - Поворачивать - Verb
Idolize - Боготворить - Verb
Strengthen - Усиливать - Verb
Guess - Отгадать - Verb
Break up - Расставаться - Verb
Discover - Открыть - Verb
Impress - Впечатлять - Verb
Push - Толкать - Verb
Prescribe - Прописывать лекарство - Verb
Repeat - Повторять - Verb
Teach - Учат, обучать - Verb
Predict - Предсказывать - Verb
Confirm - Подтвердить - Verb
Play - Играть - Verb
To correct - Исправить - Verb
Answer - Отвечать - Verb
Choose - Выбирать - Verb
Lose - Проигрывать - Verb
Boast - Хвастаться - Verb
Build - Строить - Verb
Apologize - Извиняться - Verb
Fill - Наполнять - Verb
Cancel - Отмена - Verb
Assume - Предполагать - Verb
Let - Позволять - Verb
Punish - Наказывать - Verb
Woke up - Проснулся - Verb
Access - Получить доступ - Verb
Intend - Намереваться - Verb
Evolve - Развиваться - Verb
Meet - Встречать(ся) - Verb
Hesitate - Колебатся, ожидать - Verb
Wish - Желать - Verb
Wrap - Заворачивать - Verb
Wake - Будить - Verb
Launch - Запуск - Verb
Apply - Применить, подать заявку, занести - Verb
Delay - Задерживаться - Verb
Resemble - Похож - Verb
Cut - Резать - Verb
Startle - Вздрагивать - Verb
Idealize - Идеализировать - Verb
Striven - Стремиться - Verb
Avoid - Уникати - Verb
Break - Ломать, перерыв - Verb
Win - Побеждать - Verb
Catch - Поймать - Verb
Adapt - Адаптировать - Verb
Exclaim - Восклицать - Verb
Split up - Разделять - Verb
Shave - Бриться - Verb
Tremble - Дрожать - Verb
Obscure - Затемнять - Verb
Comment on - Комментировать - Verb
Quarrel - Ссориться - Verb
Tell - Говорить (кому то) - Verb
Beat - Бить - Verb
Stay - оставаться - Verb
Fix - Исправить - Verb
Test - Тестировать - Verb
Try - Пробовать - Verb
Affect - Влиять, действовать - Verb
Emigrate - Эмигрировать - Verb
Sneak - Красться - Verb
Run - Бежать - Verb
Buy - Покупать - Verb
Stop - Останавливать - Verb
Pay - Платить - Verb
Fulfill - Выполнить - Verb
Communicate - Общаться - Verb
Walk - Идти пешком - Verb
Admit - Признавать - Verb
Care - Заботится - Verb
Imitate - Подражать - Verb
Work - Работать - Verb
Continue - Продолжать - Verb
Extend - Продлевать - Verb
Wonder - интересоваться, желать знать - Verb
Suggested - Предлагал (past) - Verb
Flutter - Порхать - Verb
Quite - Покидать - Verb
Sleep - Спать - Verb
Leap - Прыгнуть - Verb
Lengthen - Удлинять - Verb
Go - Идти - Verb
Allow - Разрешать (дозволяти) - Verb
Use - Использовать - Verb
Omit - Пропускать - Verb
Remain - Остатся, продержатся - Verb
Put - Класть - Verb
Implement - Осуществлять - Verb
Outclasses - Превосходит - Verb
Suggest - Предлагать - Verb
Change - Изменять - Verb
Cure - Излечивать - Verb
Conduct - Проводить - Verb
Live - Жить - Verb
Spread - Распространение - Verb
Stare - Глазеть - Verb
Look at - Смотреть на - Verb
Fight - Драться - Verb
Call - Вызов, призыв, зов - Verb
Write - Писать - Verb
Hire - Нанимать - Verb
Subtract - Вычитать - Verb
Begin - Начинать - Verb
Start - Начинать - Verb
Restrict - Ограничивать - Verb
Manipulate - Манипулировать - Verb
Jump - Прыгнуть - Verb
Cite - Цитировать - Verb
Collaborate - Сотрудничать - Verb
Bless - Благословить - Verb
Collect - Коллекционировать, подбирать - Verb
Risk - Рисковать - Verb
Employ - Нанимать - Verb
Kidding - Шутя - Verb
Lift - Поднимать - Verb
Leave - Покидать - Verb
Hijack - Угнать - Verb
Shorten - Сокращать - Verb
Exclude - Исключать - Verb
Upload - Загрузить - Verb
Crawl - Ползти - Verb
Exaggerate - Преувеличивать - Verb
Passed - Сдал, прошел (past) - Verb
Kick - Удар ногой - Verb
Repair - Исправить - Verb
Motivate - Мотивировать - Verb
Sing - Петь - Verb
Swap - Менять - Verb
Postpone - Откладывать (на потом) - Verb
Embed - Встраивать - Verb
Hide - Скрывать - Verb
Unload - Разгружать - Verb
Smile - Улыбаться - Verb
Edite - Редактировать - Verb
Suspect - Подозревать - Verb
Pack - Упаковать - Verb
Sit - Сидеть - Verb
Decrease - Уменьшать - Verb
Represent - Представлять - Verb
Argue - Спорить - Verb
Remain - Оставаться - Verb
Rescue - Спасать - Verb
Fall - Падать - Verb
Notify - Уведомлять - Verb
Conceal - Скрывать - Verb
Remark - высказаться - Verb
Double - Удвоить - Verb
Guarantee - Гарантировать - Verb
Instruct - Инструктировать - Verb
Adopt - Усыновить - Verb
Retire - Устраняться - Verb
Confuse - Перепутать - Verb
Imagine - Воображать - Verb
Perform - Исполнять (выступать) - Verb
Convince - Убеждать - Verb
Reached - Достиг - Verb
Mishear - Ослышаться - Verb
Congratulate - Поздравлять - Verb
Fade - Угасать, Тускнеть - Verb
Stayed - Оставался (past) - Verb
Violate - Нарушать - Verb
Give - Давать - Verb
Dedicate - Посвящать - Verb
Cough - Кашлять - Verb
Confiscate - Конфисковать - Verb
Exceed - Превосходить - Verb
Cry - Плакать - Verb
Help - Помогать - Verb
Download - Скачать - Verb
Interrupt - Перебивать - Verb
Produce - Производить - Verb
Boil - Кипятить - Verb
Defend - Защищать - Verb
Accept - Принять - Verb
Prohibit - Запрещать - Verb
Print - Печатать - Verb
Dream - Мечтать - Verb
Suffer - Страдать - Verb
Occur - Происходить - Verb
Cook - Готовить - Verb
Move - Двигаться - Verb
Led - Управлять - Verb
Receive - Получать, принимать - Verb
Invite - Приглашать - Verb
Mix - Смешивать - Verb
Regret - Сожалеть - Verb
Overrid - Переопределить - Verb
Born - Родиться - Verb
Hope - Надеяться - Verb
Cycling - Кататься на велосипеде - Verb
Educate - Обучать - Verb
Isolate - Изолировать - Verb
Combines - Сочетает в себе - Verb
Moved - Переехал (past) - Verb
Offset - Компенсировать - Verb
Listen - Слушать - Verb
Reach - доезжать, достигать - Verb
Score - Набирать (очки) - Verb
Open - Открывать - Verb
Characterize - Характеризовать - Verb
Be idle - Бездействовать - Verb
Acquire - Приобретать - Verb
Prevent - Запобігти - Verb
Renew - Обновить - Verb
Adopts - Принимает - Verb
Differ - Отличаться - Verb
Release - Выпускать - Verb
Gather - Собирать - Verb
Reduce - Уменьшить - Verb
Introduce - Представить - Verb
Disapprove - Не одобрять - Verb
Squeeze - Сжимать - Verb
To Terminate - Прекратить - Verb
Publish - Публиковать - Verb
Attack - Атаковать - Verb
Envy - Завидовать - Verb
Shine - Светить - Verb
Cross - Пересекать - Verb
Sound - Звучать - Verb
Swim - Плавать - Verb
Unite - Объединять - Verb
Note - Заметить - Verb
Truncate - Обрезать - Verb
Appreciate - Ценить - Verb
Windy - Ветреный - Weather
Gloomy - Пасмурный - Weather
Get dark - Темнеет - Weather
Will finish doing - Закончу делать (Будущее) - Will
Useless - Бесполезный - Work
Complain - Жалуется - Work
Append - Добавить, присоединять - Work
Rich - Богатый - Work
Get a job - Получить работу - Work
Decision - Решение - Work
Width - Ширина - Work
Data - Данные - Work
Guard - Охранник - Work
Success - Успех - Work
Angry - Злой - Work
Clever - Умный - Work
False - Не правда - Work
Legal - Законный - Work
Armchair - Кресло - Work
Useful - Полезный - Work
Commercial - Коммерческий - Work
Sign - Подписать - Work
Earn - Заработать - Work
Unknown - Неизвестно - Work
Event - Событие - Work
Opinion - Мнение - Work
Police - Полиция - Work
Article - Статья - Work
Famous - Известный - Work
Memory - Память - Work
Range - Диапазон - Work
Important - Важный - Work
Equal - Одинаковые - Work
Quantity - Количество - Work
Chief - Начальник - Work
Ineffective - Неэффективно - Work
Disagree - Не согласен - Work
Alone - (живёт) сама - Youtube
Tasty - Вкусно - Youtube
Experience - Опыт - Youtube
Furniture - Мебель - Youtube
Illness - Болезнь (простуда) - Youtube
Criticize - Критиковать - Youtube
Elder - Старше - Youtube
Behaviour - Поведение - Youtube
Delicious - Очень вкусно - Youtube
Separately - Раздельно - Youtube
Cost - Стоить (глагол) - Youtube
Compete - Соревноваться - Youtube
Though - Хотя, однако, несмотря на, даже, всё таки - conjunction
Whenever - Когда угодно - conjunction
The only - Единственный - idiom
Where from - От куда? - idiom
Come came come - Вернуть - irregular verbs
Would - Как бы - modal verb
Refer - Ссылаться - phrasal verb
What about - О чём? - pronoun, determiner
Whose - Чей, чья - pronoun, determiner
Several - Несколько - pronoun, determiner
Seventeen - 17 - Число
Seven - 7 - Число
Twelve - 12 - Число
First - Первый - Число
Eleven - 11 - Число
Two - 2 - Число
Number - Число - Число
Fifteen - 15 - Число
Third - Третий - Число
Fourteen - 14 - Число
Eighteen - 18 - Число
Nineteen - 19 - Число
Sixteen - 16 - Число
Ten - 10 - Число
One - 1 - Число
Zero - 0 - Число
Twenty - 20 - Число
Nine - 9 - Число
Pair - Пара - Число
Six - 6 - Число
Five - 5 - Число
Thirteen - 13 - Число
Hundred - 100 (сто) - Число
one thousand - 1000 - Число
Second - Второй - Число
Four - 4 - Число
Three - 3 - Число
Eight - 8 - Число
